Bénéficiaires,Date de la demande,Montant total des chèques technologiques,Feder décidées,Part wallonne décidées,Montants cofinancés décidées,Feder payées,Part wallonne payées,Montants cofinancés payées,Date de clôture,project
CILBiotech,22/12/2008,3000,900,1350,2250,900,1350,2250,21/04/2011,Mesure 2.01 : Stimulation du potentiel technologique des PME (Action 2.1.4 - Chèques Technologiques)
SA Bouchons Leclerq et Fils,19/12/2008,8500,2550,3825,6375,2550,3825,6375,1/12/2009,Mesure 2.01 : Stimulation du potentiel technologique des PME (Action 2.1.4 - Chèques Technologiques)
FIB - SERVICES,22/12/2008,20000,6000,9000,15000,6000,9000,15000,30/07/2009,Mesure 2.01 : Stimulation du potentiel technologique des PME (Action 2.1.4 - Chèques Technologiques)
SA Selligent,04/02/2009,3000,900,1350,2250,900,1350,2250,2/12/2009,Mesure 2.01 : Stimulation du potentiel technologique des PME (Action 2.1.4 - Chèques Technologiques)
CILBiotech,09/02/2009,19500,5850,8775,14625,5850,8775,14625,18/08/2009,Mesure 2.01 : Stimulation du potentiel technologique des PME (Action 2.1.4 - Chèques Technologiques)
SA Bone Therapeutics,05/03/2009,4000,1200,1800,3000,1200,1800,3000,20/08/2009,Mesure 2.01 : Stimulation du potentiel technologique des PME (Action 2.1.4 - Chèques Technologiques)
XYLOWATT,13/03/2009,1500,450,675,1125,450,675,1125,20/05/2009,Mesure 2.01 : Stimulation du potentiel technologique des PME (Action 2.1.4 - Chèques Technologiques)
SA Beads Belgium,15/04/2009,20000,6000,9000,15000,6000,9000,15000,07/04/2010,Mesure 2.01 : Stimulation du potentiel technologique des PME (Action 2.1.4 - Chèques Technologiques)
it4ip,30/03/2009,1500,450,675,1125,450,675,1125,12/06/2009,Mesure 2.01 : Stimulation du potentiel technologique des PME (Action 2.1.4 - Chèques Technologiques)
MALEX,06/04/2009,16500,4950,7425,12375,4950,7425,12375,24/06/2009,Mesure 2.01 : Stimulation du potentiel technologique des PME (Action 2.1.4 - Chèques Technologiques)
UNIFAST DAUDE,09/04/2009,1500,450,675,1125,450,675,1125,12/06/2009,Mesure 2.01 : Stimulation du potentiel technologique des PME (Action 2.1.4 - Chèques Technologiques)
THERMIBEL,26/05/2009,2000,600,900,1500,600,900,1500,25/03/2010,Mesure 2.01 : Stimulation du potentiel technologique des PME (Action 2.1.4 - Chèques Technologiques)
Etablissements Jarilux,06/05/2009,1000,300,450,750,300,450,750,30/07/2009,Mesure 2.01 : Stimulation du potentiel technologique des PME (Action 2.1.4 - Chèques Technologiques)
VITALTRONICS,22/04/2009,8500,2550,3825,6375,2550,3825,6375,18/01/2010,Mesure 2.01 : Stimulation du potentiel technologique des PME (Action 2.1.4 - Chèques Technologiques)
Humiva,08/05/2009,16500,4950,7425,12375,4950,7425,12375,14/12/2010,Mesure 2.01 : Stimulation du potentiel technologique des PME (Action 2.1.4 - Chèques Technologiques)
Scaldis Saint-Martin,06/05/2009,18000,5400,8100,13500,5400,8100,13500,14/12/2009,Mesure 2.01 : Stimulation du potentiel technologique des PME (Action 2.1.4 - Chèques Technologiques)
LEBAILLY,15/05/2009,2500,750,1125,1875,750,1125,1875,11/09/2009,Mesure 2.01 : Stimulation du potentiel technologique des PME (Action 2.1.4 - Chèques Technologiques)
NEOCERAM,27/05/2009,3000,900,1350,2250,900,1350,2250,26/10/2010,Mesure 2.01 : Stimulation du potentiel technologique des PME (Action 2.1.4 - Chèques Technologiques)
NEOCERAM,27/05/2009,5000,1500,2250,3750,1500,2250,3750,03/09/2010,Mesure 2.01 : Stimulation du potentiel technologique des PME (Action 2.1.4 - Chèques Technologiques)
MOSSELMAN,15/05/2009,5500,1650,2475,4125,1650,2475,4125,30/11/2009,Mesure 2.01 : Stimulation du potentiel technologique des PME (Action 2.1.4 - Chèques Technologiques)
COVERFIL,28/05/2009,2000,600,900,1500,600,900,1500,30/10/2009,Mesure 2.01 : Stimulation du potentiel technologique des PME (Action 2.1.4 - Chèques Technologiques)
XYLOWATT,29/05/2009,2500,750,1125,1875,750,1125,1875,30/07/2009,Mesure 2.01 : Stimulation du potentiel technologique des PME (Action 2.1.4 - Chèques Technologiques)
VET,04/06/2009,4500,1350,2025,3375,1350,2025,3375,20/08/2009,Mesure 2.01 : Stimulation du potentiel technologique des PME (Action 2.1.4 - Chèques Technologiques)
LESSINES INDUSTRIES,04/06/2009,500,150,225,375,150,225,375,30/07/2009,Mesure 2.01 : Stimulation du potentiel technologique des PME (Action 2.1.4 - Chèques Technologiques)
Etablissements Jarilux,30/06/2009,1000,300,450,750,300,450,750,18/01/2010,Mesure 2.01 : Stimulation du potentiel technologique des PME (Action 2.1.4 - Chèques Technologiques)
ENGETIL,12/06/2009,18500,5550,8325,13875,5550,8325,13875,18/09/2009,Mesure 2.01 : Stimulation du potentiel technologique des PME (Action 2.1.4 - Chèques Technologiques)
Carrières de Silex du Versant de Maisières,01/07/2009,1000,300,450,750,300,450,750,30/10/2009,Mesure 2.01 : Stimulation du potentiel technologique des PME (Action 2.1.4 - Chèques Technologiques)
ACIC,22/06/2009,10000,3000,4500,7500,3000,4500,7500,11/09/2009,Mesure 2.01 : Stimulation du potentiel technologique des PME (Action 2.1.4 - Chèques Technologiques)
VITALTRONICS,11/09/2009,4500,1350,2025,3375,1350,2025,3375,19/01/2010,Mesure 2.01 : Stimulation du potentiel technologique des PME (Action 2.1.4 - Chèques Technologiques)
COMET TRAITEMENTS,21/08/2009,3500,1050,1575,2625,1050,1575,2625,9/10/2009,Mesure 2.01 : Stimulation du potentiel technologique des PME (Action 2.1.4 - Chèques Technologiques)
BIZZDEV,07/09/2009,13000,3900,5850,9750,3900,5850,9750,30/11/2009,Mesure 2.01 : Stimulation du potentiel technologique des PME (Action 2.1.4 - Chèques Technologiques)
RECOVAL BELGIUM,10/07/2009,5500,1650,2475,4125,1650,2475,4125,03/05/2010,Mesure 2.01 : Stimulation du potentiel technologique des PME (Action 2.1.4 - Chèques Technologiques)
Caulier developpement s.a,10/07/2009,14000,4200,6300,10500,4200,6300,10500,26/03/2010,Mesure 2.01 : Stimulation du potentiel technologique des PME (Action 2.1.4 - Chèques Technologiques)
Etablissements Robert Stiernon,16/07/2009,1500,450,675,1125,450,675,1125,11/09/2009,Mesure 2.01 : Stimulation du potentiel technologique des PME (Action 2.1.4 - Chèques Technologiques)
PLASTISERVICE,16/07/2009,17000,5100,7650,12750,1650,2475,4125,22/12/2010,Mesure 2.01 : Stimulation du potentiel technologique des PME (Action 2.1.4 - Chèques Technologiques)
Sélecta,27/07/2009,1000,300,450,750,300,450,750,25/08/2009,Mesure 2.01 : Stimulation du potentiel technologique des PME (Action 2.1.4 - Chèques Technologiques)
LEBAILLY,22/09/2009,1500,450,675,1125,450,675,1125,22/02/2010,Mesure 2.01 : Stimulation du potentiel technologique des PME (Action 2.1.4 - Chèques Technologiques)
it4ip,11/08/2009,2500,750,1125,1875,750,1125,1875,9/10/2009,Mesure 2.01 : Stimulation du potentiel technologique des PME (Action 2.1.4 - Chèques Technologiques)
SEDIS LOGISTICS,26/08/2009,9500,2850,4275,7125,2850,4275,7125,18/06/2010,Mesure 2.01 : Stimulation du potentiel technologique des PME (Action 2.1.4 - Chèques Technologiques)
FIB - SERVICES,25/09/2009,14000,4200,6300,10500,4200,6300,10500,26/04/2010,Mesure 2.01 : Stimulation du potentiel technologique des PME (Action 2.1.4 - Chèques Technologiques)
ALTER ENERGY,24/09/2009,2000,600,900,1500,600,900,1500,14/12/2009,Mesure 2.01 : Stimulation du potentiel technologique des PME (Action 2.1.4 - Chèques Technologiques)
Ecolair SA,08/09/2009,10500,3150,4725,7875,3150,4725,7875,18/11/2011,Mesure 2.01 : Stimulation du potentiel technologique des PME (Action 2.1.4 - Chèques Technologiques)
ACIC,08/09/2009,10000,3000,4500,7500,3000,4500,7500,14/12/2009,Mesure 2.01 : Stimulation du potentiel technologique des PME (Action 2.1.4 - Chèques Technologiques)
PROPHAREX,18/09/2009,1000,300,450,750,300,450,750,30/11/2009,Mesure 2.01 : Stimulation du potentiel technologique des PME (Action 2.1.4 - Chèques Technologiques)
DEVAS,19/10/2009,1000,300,450,750,300,450,750,15/03/2010,Mesure 2.01 : Stimulation du potentiel technologique des PME (Action 2.1.4 - Chèques Technologiques)
LESSINES INDUSTRIES,2/10/2009,1000,300,450,750,300,450,750,14/12/2009,Mesure 2.01 : Stimulation du potentiel technologique des PME (Action 2.1.4 - Chèques Technologiques)
PACK - O - PLAST,21/10/2009,6000,1800,2700,4500,1800,2700,4500,07/09/2010,Mesure 2.01 : Stimulation du potentiel technologique des PME (Action 2.1.4 - Chèques Technologiques)
ETABLISSEMENTS ROBERT STIERNON,6/10/2009,1500,450,675,1125,450,675,1125,14/12/2009,Mesure 2.01 : Stimulation du potentiel technologique des PME (Action 2.1.4 - Chèques Technologiques)
CASTEL ENGINEERING,27/10/2009,2500,750,1125,1875,750,1125,1875,26/08/2011,Mesure 2.01 : Stimulation du potentiel technologique des PME (Action 2.1.4 - Chèques Technologiques)
DVL _ K,16/10/2009,1000,300,450,750,300,450,750,30/11/2009,Mesure 2.01 : Stimulation du potentiel technologique des PME (Action 2.1.4 - Chèques Technologiques)
Usines et Carrières Ernest Lebailly,8/10/2009,2500,750,1125,1875,750,1125,1875,30/11/2009,Mesure 2.01 : Stimulation du potentiel technologique des PME (Action 2.1.4 - Chèques Technologiques)
Carrières de Silex du Versant de Maisières,22/11/2009,1000,300,450,750,300,450,750,25/03/2010,Mesure 2.01 : Stimulation du potentiel technologique des PME (Action 2.1.4 - Chèques Technologiques)
MOSSELMAN,20/10/2009,3000,900,1350,2250,900,1350,2250,10/12/2010,Mesure 2.01 : Stimulation du potentiel technologique des PME (Action 2.1.4 - Chèques Technologiques)
COVERFIL,28/10/2009,2000,600,900,1500,600,900,1500,04/04/2011,Mesure 2.01 : Stimulation du potentiel technologique des PME (Action 2.1.4 - Chèques Technologiques)
LE TISSAGE D'ARCADE,17/11/2009,7500,2250,3375,5625,2250,3375,5625,17/05/2010,Mesure 2.01 : Stimulation du potentiel technologique des PME (Action 2.1.4 - Chèques Technologiques)
ALKAR TECHNOLOGY,21/11/2009,2500,750,1125,1875,750,1125,1875,26/04/2010,Mesure 2.01 : Stimulation du potentiel technologique des PME (Action 2.1.4 - Chèques Technologiques)
BIZZDEV,18/11/2009,7000,2100,3150,5250,2100,3150,5250,21/06/2011,Mesure 2.01 : Stimulation du potentiel technologique des PME (Action 2.1.4 - Chèques Technologiques)
ACAPELA GROUP BABEL TECHNOLOGIES,16/11/2009,9000,2700,4050,6750,2700,4050,6750,01/07/2010,Mesure 2.01 : Stimulation du potentiel technologique des PME (Action 2.1.4 - Chèques Technologiques)
EONIX,17/11/2009,1500,450,675,1125,450,675,1125,18/01/2010,Mesure 2.01 : Stimulation du potentiel technologique des PME (Action 2.1.4 - Chèques Technologiques)
Usines et Carrières Ernest Lebailly,2/12/2009,2500,750,1125,1875,750,1125,1875,23/02/2010,Mesure 2.01 : Stimulation du potentiel technologique des PME (Action 2.1.4 - Chèques Technologiques)
ETABLISSEMENTS ROBERT STIERNON ,29/11/2009,2000,600,900,1500,600,900,1500,18/01/2010,Mesure 2.01 : Stimulation du potentiel technologique des PME (Action 2.1.4 - Chèques Technologiques)
Usines et Carrières Ernest Lebailly,3/12/2009,2500,750,1125,1875,750,1125,1875,05/02/2010,Mesure 2.01 : Stimulation du potentiel technologique des PME (Action 2.1.4 - Chèques Technologiques)
N.T.,25/11/2009,5000,1500,2250,3750,1500,2250,3750,25/03/2010,Mesure 2.01 : Stimulation du potentiel technologique des PME (Action 2.1.4 - Chèques Technologiques)
ETABLISSEMENTS ROBERT STIERNON,26/11/2009,1500,450,675,1125,450,675,1125,18/01/2010,Mesure 2.01 : Stimulation du potentiel technologique des PME (Action 2.1.4 - Chèques Technologiques)
Selecta,26/11/2009,19000,5700,8550,14250,5700,8550,14250,19/08/2010,Mesure 2.01 : Stimulation du potentiel technologique des PME (Action 2.1.4 - Chèques Technologiques)
A.M.B.,26/11/2009,2000,600,900,1500,600,900,1500,15/12/2009,Mesure 2.01 : Stimulation du potentiel technologique des PME (Action 2.1.4 - Chèques Technologiques)
Usines et Carrières Ernest Lebailly,2/12/2009,500,150,225,375,150,225,375,18/01/2010,Mesure 2.01 : Stimulation du potentiel technologique des PME (Action 2.1.4 - Chèques Technologiques)
FIB - SERVICES,26/01/2010,6000,1800,2700,4500,1800,2700,4500,01/09/2011,Mesure 2.01 : Stimulation du potentiel technologique des PME (Action 2.1.4 - Chèques Technologiques)
ETABLISSEMENTS ROBERT STIERNON,9/12/2009,1500,450,675,1125,450,675,1125,05/02/2010,Mesure 2.01 : Stimulation du potentiel technologique des PME (Action 2.1.4 - Chèques Technologiques)
BIOHAINAUT,10/12/2009,1000,300,450,750,300,450,750,18/01/2010,Mesure 2.01 : Stimulation du potentiel technologique des PME (Action 2.1.4 - Chèques Technologiques)
METAL QUARTZ,17/12/2009,6500,1950,2925,4875,1950,2925,4875,26/08/2011,Mesure 2.01 : Stimulation du potentiel technologique des PME (Action 2.1.4 - Chèques Technologiques)
Uniwan,11/01/2010,9500,2850,4275,7125,2850,4275,7125,16/03/2011,Mesure 2.01 : Stimulation du potentiel technologique des PME (Action 2.1.4 - Chèques Technologiques)
H.O.P.,17/12/2009,20000,6000,9000,15000,6000,9000,15000,19/08/2010,Mesure 2.01 : Stimulation du potentiel technologique des PME (Action 2.1.4 - Chèques Technologiques)
INTERSYSTO,21/12/2009,20000,6000,9000,15000,6000,9000,15000,22/11/2010,Mesure 2.01 : Stimulation du potentiel technologique des PME (Action 2.1.4 - Chèques Technologiques)
EONIX,18/12/2009,18500,5550,8325,13875,5550,8325,13875,10/12/2010,Mesure 2.01 : Stimulation du potentiel technologique des PME (Action 2.1.4 - Chèques Technologiques)
DIAROTECH,31/03/2010,15000,4500,6750,11250,4500,6750,11250,11/10/2011,Mesure 2.01 : Stimulation du potentiel technologique des PME (Action 2.1.4 - Chèques Technologiques)
MULTIMEDIA TRADING INTERNATIONAL,23/12/2009,20000,6000,9000,15000,6000,9000,15000,3/11/2011,Mesure 2.01 : Stimulation du potentiel technologique des PME (Action 2.1.4 - Chèques Technologiques)
CERSA,12/02/2010,12000,3600,5400,9000,3600,5400,9000,23/09/2010,Mesure 2.01 : Stimulation du potentiel technologique des PME (Action 2.1.4 - Chèques Technologiques)
WEBVEILLE,07/01/2010,19500,5850,8775,14625,5850,8775,14625,24/02/2011,Mesure 2.01 : Stimulation du potentiel technologique des PME (Action 2.1.4 - Chèques Technologiques)
Etablissements Jarilux,12/01/2010,1000,300,450,750,300,450,750,15/10/2010,Mesure 2.01 : Stimulation du potentiel technologique des PME (Action 2.1.4 - Chèques Technologiques)
EUROSCREEN,13/01/2010,5500,1650,2475,4125,1650,2475,4125,26/04/2010,Mesure 2.01 : Stimulation du potentiel technologique des PME (Action 2.1.4 - Chèques Technologiques)
A. LANDGRAF,22/01/2010,3000,900,1350,2250,900,1350,2250,16/03/2011,Mesure 2.01 : Stimulation du potentiel technologique des PME (Action 2.1.4 - Chèques Technologiques)
BIOHAINAUT,15/01/2010,1000,300,450,750,300,450,750,10/12/2010,Mesure 2.01 : Stimulation du potentiel technologique des PME (Action 2.1.4 - Chèques Technologiques)
CARBONETTA,12/02/2010,1500,450,675,1125,450,675,1125,08/03/2010,Mesure 2.01 : Stimulation du potentiel technologique des PME (Action 2.1.4 - Chèques Technologiques)
LEBAILLY,01/02/2010,500,150,225,375,150,225,375,08/03/2010,Mesure 2.01 : Stimulation du potentiel technologique des PME (Action 2.1.4 - Chèques Technologiques)
LEBAILLY,01/02/2010,3000,900,1350,2250,900,1350,2250,03/05/2010,Mesure 2.01 : Stimulation du potentiel technologique des PME (Action 2.1.4 - Chèques Technologiques)
NEW TECHNELEC,29/03/2010,7000,2100,3150,5250,2100,3150,5250,12/01/2011,Mesure 2.01 : Stimulation du potentiel technologique des PME (Action 2.1.4 - Chèques Technologiques)
REDDY,23/02/2010,9500,2850,4275,7125,2850,4275,7125,07/09/2011,Mesure 2.01 : Stimulation du potentiel technologique des PME (Action 2.1.4 - Chèques Technologiques)
CARBONETTA,09/03/2010,4000,1200,1800,3000,1200,1800,3000,27/07/2010,Mesure 2.01 : Stimulation du potentiel technologique des PME (Action 2.1.4 - Chèques Technologiques)
Feronyl,08/03/2010,8000,2400,3600,6000,2400,3600,6000,22/12/2011,Mesure 2.01 : Stimulation du potentiel technologique des PME (Action 2.1.4 - Chèques Technologiques)
BOUCHONS LECLERCQ ET FILS,09/03/2010,5500,1650,2475,4125,1650,2475,4125,30/04/2012,Mesure 2.01 : Stimulation du potentiel technologique des PME (Action 2.1.4 - Chèques Technologiques)
ETABLISSEMENTS ROBERT STIERNON,10/03/2010,500,150,225,375,150,225,375,07/04/2010,Mesure 2.01 : Stimulation du potentiel technologique des PME (Action 2.1.4 - Chèques Technologiques)
COMET TRAITEMENTS,18/03/2010,2500,750,1125,1875,750,1125,1875,07/04/2010,Mesure 2.01 : Stimulation du potentiel technologique des PME (Action 2.1.4 - Chèques Technologiques)
ACIC,18/03/2010,20000,6000,9000,15000,6000,9000,15000,26/10/2010,Mesure 2.01 : Stimulation du potentiel technologique des PME (Action 2.1.4 - Chèques Technologiques)
Usines et Carrières Ernest Lebailly,23/03/2010,3000,900,1350,2250,900,1350,2250,26/04/2010,Mesure 2.01 : Stimulation du potentiel technologique des PME (Action 2.1.4 - Chèques Technologiques)
DEVAS,31/03/2010,1000,300,450,750,300,450,750,29/06/2010,Mesure 2.01 : Stimulation du potentiel technologique des PME (Action 2.1.4 - Chèques Technologiques)
Le PASS,12/04/2010,7000,2100,3150,5250,2100,3150,5250,23/09/2010,Mesure 2.01 : Stimulation du potentiel technologique des PME (Action 2.1.4 - Chèques Technologiques)
Uniteq,19/04/2010,18000,5400,8100,13500,5400,8100,13500,24/02/2011,Mesure 2.01 : Stimulation du potentiel technologique des PME (Action 2.1.4 - Chèques Technologiques)
BEADS BELGIUM,20/04/2010,20000,6000,9000,15000,6000,9000,15000,06/06/2011,Mesure 2.01 : Stimulation du potentiel technologique des PME (Action 2.1.4 - Chèques Technologiques)
LESSINES INDUSTRIES,11/05/2010,500,150,225,375,150,225,375,15/06/2010,Mesure 2.01 : Stimulation du potentiel technologique des PME (Action 2.1.4 - Chèques Technologiques)
ROOSENS BETONS,16/06/2010,12500,3750,5625,9375,3750,5625,9375,09/05/2011,Mesure 2.01 : Stimulation du potentiel technologique des PME (Action 2.1.4 - Chèques Technologiques)
COMET TRAITEMENTS,17/05/2010,2000,600,900,1500,600,900,1500,05/08/2010,Mesure 2.01 : Stimulation du potentiel technologique des PME (Action 2.1.4 - Chèques Technologiques)
Desobry,27/05/2010,7000,2100,3150,5250,2100,3150,5250,21/06/2011,Mesure 2.01 : Stimulation du potentiel technologique des PME (Action 2.1.4 - Chèques Technologiques)
SOCIETE COMINOISE DE MAILLE INDUSTRIELLE,31/05/2010,10000,3000,4500,7500,3000,4500,7500,11/10/2011,Mesure 2.01 : Stimulation du potentiel technologique des PME (Action 2.1.4 - Chèques Technologiques)
N.T.,13/07/2010,6500,1950,2925,4875,1950,2925,4875,01/02/2011,Mesure 2.01 : Stimulation du potentiel technologique des PME (Action 2.1.4 - Chèques Technologiques)
N.T.,13/07/2010,12500,3750,5625,9375,3750,5625,9375,16/03/2011,Mesure 2.01 : Stimulation du potentiel technologique des PME (Action 2.1.4 - Chèques Technologiques)
SEDIS LOGISTICS,15/07/2010,3000,900,1350,2250,900,1350,2250,30/05/2012,Mesure 2.01 : Stimulation du potentiel technologique des PME (Action 2.1.4 - Chèques Technologiques)
CABINET DE MEDECINE GENERALE JAMOULLE & ASSOCIES,29/06/2010,11500,3450,5175,8625,3450,5175,8625,26/08/2011,Mesure 2.01 : Stimulation du potentiel technologique des PME (Action 2.1.4 - Chèques Technologiques)
SOCIETE BELGE D'INFORMATIQUE MEDICALE,22/06/2010,10000,3000,4500,7500,3000,4500,7500,27/01/2011,Mesure 2.01 : Stimulation du potentiel technologique des PME (Action 2.1.4 - Chèques Technologiques)
TAGEXPERT,21/06/2010,6000,1800,2700,4500,1800,2700,4500,03/09/2010,Mesure 2.01 : Stimulation du potentiel technologique des PME (Action 2.1.4 - Chèques Technologiques)
AGRINOVA,19/07/2010,13000,3900,5850,9750,3900,5850,9750,6/10/2010,Mesure 2.01 : Stimulation du potentiel technologique des PME (Action 2.1.4 - Chèques Technologiques)
XYLOWATT,12/07/2010,3000,900,1350,2250,900,1350,2250,23/09/2010,Mesure 2.01 : Stimulation du potentiel technologique des PME (Action 2.1.4 - Chèques Technologiques)
ALKAR TECHNOLOGY,09/08/2010,6000,1800,2700,4500,1800,2700,4500,16/05/2011,Mesure 2.01 : Stimulation du potentiel technologique des PME (Action 2.1.4 - Chèques Technologiques)
SICAFI,20/09/2010,1000,300,450,750,300,450,750,18/07/2011,Mesure 2.01 : Stimulation du potentiel technologique des PME (Action 2.1.4 - Chèques Technologiques)
A.M.B.,23/08/2010,1500,450,675,1125,450,675,1125,6/10/2010,Mesure 2.01 : Stimulation du potentiel technologique des PME (Action 2.1.4 - Chèques Technologiques)
GEOTEC INTERNATIONAL,25/08/2010,500,150,225,375,150,225,375,6/10/2010,Mesure 2.01 : Stimulation du potentiel technologique des PME (Action 2.1.4 - Chèques Technologiques)
LE TISSAGE D'ARCADE,06/09/2010,7500,2250,3375,5625,2250,3375,5625,16/03/2011,Mesure 2.01 : Stimulation du potentiel technologique des PME (Action 2.1.4 - Chèques Technologiques)
TAGEXPERT,02/09/2010,14000,4200,6300,10500,4200,6300,10500,5/11/2010,Mesure 2.01 : Stimulation du potentiel technologique des PME (Action 2.1.4 - Chèques Technologiques)
CABAY TRANSPORT,01/09/2010,500,150,225,375,150,225,375,6/10/2010,Mesure 2.01 : Stimulation du potentiel technologique des PME (Action 2.1.4 - Chèques Technologiques)
METAL QUARTZ,16/11/2010,2500,750,1125,1875,750,1125,1875,26/08/2011,Mesure 2.01 : Stimulation du potentiel technologique des PME (Action 2.1.4 - Chèques Technologiques)
ROOSENS BETONS,06/09/2010,2500,750,1125,1875,750,1125,1875,24/04/2012,Mesure 2.01 : Stimulation du potentiel technologique des PME (Action 2.1.4 - Chèques Technologiques)
H.O.P.,08/09/2010,20000,6000,9000,15000,6000,9000,15000,27/06/2011,Mesure 2.01 : Stimulation du potentiel technologique des PME (Action 2.1.4 - Chèques Technologiques)
MAN-TO-TREE,13/09/2010,17000,5100,7650,12750,5100,7650,12750,06/09/2011,Mesure 2.01 : Stimulation du potentiel technologique des PME (Action 2.1.4 - Chèques Technologiques)
XYLOWATT,14/09/2010,500,150,225,375,150,225,375,23/09/2010,Mesure 2.01 : Stimulation du potentiel technologique des PME (Action 2.1.4 - Chèques Technologiques)
COMET TRAITEMENTS,16/09/2010,5500,1650,2475,4125,1650,2475,4125,16/05/2011,Mesure 2.01 : Stimulation du potentiel technologique des PME (Action 2.1.4 - Chèques Technologiques)
SICAFI,21/09/2010,1000,300,450,750,300,450,750,18/07/2011,Mesure 2.01 : Stimulation du potentiel technologique des PME (Action 2.1.4 - Chèques Technologiques)
CRESCENDO CONSULTING,28/09/2010,10500,3150,4725,7875,3150,4725,7875,22/12/2010,Mesure 2.01 : Stimulation du potentiel technologique des PME (Action 2.1.4 - Chèques Technologiques)
A.M.B.,29/09/2010,3000,900,1350,2250,900,1350,2250,10/12/2010,Mesure 2.01 : Stimulation du potentiel technologique des PME (Action 2.1.4 - Chèques Technologiques)
CABAY TRANSPORT,1/10/2010,2500,750,1125,1875,750,1125,1875,27/01/2011,Mesure 2.01 : Stimulation du potentiel technologique des PME (Action 2.1.4 - Chèques Technologiques)
Desobry,12/10/2010,3500,1050,1575,2625,1050,1575,2625,06/06/2011,Mesure 2.01 : Stimulation du potentiel technologique des PME (Action 2.1.4 - Chèques Technologiques)
MADE IN POWER,21/10/2010,7500,2250,3375,5625,2250,3375,5625,28/06/2011,Mesure 2.01 : Stimulation du potentiel technologique des PME (Action 2.1.4 - Chèques Technologiques)
it4ip,22/10/2010,6500,1950,2925,4875,1950,2925,4875,3/11/2011,Mesure 2.01 : Stimulation du potentiel technologique des PME (Action 2.1.4 - Chèques Technologiques)
MENUISERIE E.M.A.C.,23/11/2010,8500,2550,3825,6375,2550,3825,6375,26/08/2011,Mesure 2.01 : Stimulation du potentiel technologique des PME (Action 2.1.4 - Chèques Technologiques)
INTERSYSTO,26/11/2010,20000,6000,9000,15000,6000,9000,15000,01/02/2011,Mesure 2.01 : Stimulation du potentiel technologique des PME (Action 2.1.4 - Chèques Technologiques)
A.M.B.,22/11/2010,3000,900,1350,2250,900,1350,2250,22/03/2011,Mesure 2.01 : Stimulation du potentiel technologique des PME (Action 2.1.4 - Chèques Technologiques)
CILBiotech,6/12/2010,17000,5100,7650,12750,5100,7650,12750,22/12/2011,Mesure 2.01 : Stimulation du potentiel technologique des PME (Action 2.1.4 - Chèques Technologiques)
NEOCERAM,25/11/2010,4000,1200,1800,3000,1200,1800,3000,31/12/2010,Mesure 2.01 : Stimulation du potentiel technologique des PME (Action 2.1.4 - Chèques Technologiques)
HAULOGY.NET,29/11/2010,20000,6000,9000,15000,6000,9000,15000,27/01/2011,Mesure 2.01 : Stimulation du potentiel technologique des PME (Action 2.1.4 - Chèques Technologiques)
CARBONETTA,16/12/2010,10500,3150,4725,7875,3150,4725,7875,20/07/2011,Mesure 2.01 : Stimulation du potentiel technologique des PME (Action 2.1.4 - Chèques Technologiques)
BIOHAINAUT,6/12/2010,5000,1500,2250,3750,1500,2250,3750,12/01/2011,Mesure 2.01 : Stimulation du potentiel technologique des PME (Action 2.1.4 - Chèques Technologiques)
LEBAILLY,10/12/2010,2500,750,1125,1875,750,1125,1875,26/08/2011,Mesure 2.01 : Stimulation du potentiel technologique des PME (Action 2.1.4 - Chèques Technologiques)
EONIX,8/12/2010,18000,5400,8100,13500,5400,8100,13500,8/12/2011,Mesure 2.01 : Stimulation du potentiel technologique des PME (Action 2.1.4 - Chèques Technologiques)
Selecta,15/12/2010,18500,5550,8325,13875,5550,8325,13875,22/12/2011,Mesure 2.01 : Stimulation du potentiel technologique des PME (Action 2.1.4 - Chèques Technologiques)
Sucrerie Couplet,10/12/2010,4000,1200,1800,3000,1200,1800,3000,14/02/2014,Mesure 2.01 : Stimulation du potentiel technologique des PME (Action 2.1.4 - Chèques Technologiques)
SOCIETE BELGE D'INFORMATIQUE MEDICALE ,10/12/2010,10000,3000,4500,7500,3000,4500,7500,30/05/2011,Mesure 2.01 : Stimulation du potentiel technologique des PME (Action 2.1.4 - Chèques Technologiques)
ACCES ECHAFAUDAGE,16/12/2010,7500,2250,3375,5625,2250,3375,5625,18/12/2012,Mesure 2.01 : Stimulation du potentiel technologique des PME (Action 2.1.4 - Chèques Technologiques)
NEOCERAM,20/12/2010,8000,2400,3600,6000,900,1350,2250,21/04/2011,Mesure 2.01 : Stimulation du potentiel technologique des PME (Action 2.1.4 - Chèques Technologiques)
ASSOCIATION INFORMATIQUE POUR LA GESTION DULOGEMENT SOCIAL ,20/12/2010,20000,6000,9000,15000,6000,9000,15000,21/06/2011,Mesure 2.01 : Stimulation du potentiel technologique des PME (Action 2.1.4 - Chèques Technologiques)
A.M.B.,12/01/2011,8500,2550,3825,6375,2550,3825,6375,29/06/2011,Mesure 2.01 : Stimulation du potentiel technologique des PME (Action 2.1.4 - Chèques Technologiques)
POMPES NEPTUNE,21/12/2010,20000,6000,9000,15000,6000,9000,15000,22/12/2011,Mesure 2.01 : Stimulation du potentiel technologique des PME (Action 2.1.4 - Chèques Technologiques)
CREACEED,18/12/2010,20000,6000,9000,15000,6000,9000,15000,27/06/2011,Mesure 2.01 : Stimulation du potentiel technologique des PME (Action 2.1.4 - Chèques Technologiques)
CRESCENDO CONSULTING,21/12/2010,9500,2850,4275,7125,2850,4275,7125,06/06/2011,Mesure 2.01 : Stimulation du potentiel technologique des PME (Action 2.1.4 - Chèques Technologiques)
SILVER RAY,21/12/2010,20000,6000,9000,15000,6000,9000,15000,19/09/2011,Mesure 2.01 : Stimulation du potentiel technologique des PME (Action 2.1.4 - Chèques Technologiques)
DATAVIN,21/12/2010,9000,2700,4050,6750,2700,4050,6750,04/07/2014,Mesure 2.01 : Stimulation du potentiel technologique des PME (Action 2.1.4 - Chèques Technologiques)
ETABLISSEMENTS ROBERT STIERNON,22/12/2010,4000,1200,1800,3000,1200,1800,3000,22/02/2013,Mesure 2.01 : Stimulation du potentiel technologique des PME (Action 2.1.4 - Chèques Technologiques)
PLASTISERVICE,22/12/2010,20000,6000,9000,15000,1950,2925,4875,13/12/2011,Mesure 2.01 : Stimulation du potentiel technologique des PME (Action 2.1.4 - Chèques Technologiques)
VERSCHUERE TECHNOLOGY,30/12/2010,7500,2250,3375,5625,2250,3375,5625,22/12/2011,Mesure 2.01 : Stimulation du potentiel technologique des PME (Action 2.1.4 - Chèques Technologiques)
Les Produits Purs de Courcelles,14/01/2011,16000,4800,7200,12000,4800,7200,12000,27/06/2011,Mesure 2.01 : Stimulation du potentiel technologique des PME (Action 2.1.4 - Chèques Technologiques)
ETABLISSEMENTS ROBERT STIERNON,06/01/2011,6500,1950,2925,4875,1950,2925,4875,16/03/2011,Mesure 2.01 : Stimulation du potentiel technologique des PME (Action 2.1.4 - Chèques Technologiques)
ACIC,13/01/2011,20000,6000,9000,15000,6000,9000,15000,08/07/2011,Mesure 2.01 : Stimulation du potentiel technologique des PME (Action 2.1.4 - Chèques Technologiques)
LESSINES INDUSTRIES,24/01/2011,8000,2400,3600,6000,2400,3600,6000,13/07/2011,Mesure 2.01 : Stimulation du potentiel technologique des PME (Action 2.1.4 - Chèques Technologiques)
FOOTIIS,01/02/2011,16000,4800,7200,12000,4800,7200,12000,28/06/2012,Mesure 2.01 : Stimulation du potentiel technologique des PME (Action 2.1.4 - Chèques Technologiques)
FRESH CONCEPT,03/03/2011,19500,5850,8775,14625,4200,6300,10500,31/10/2012,Mesure 2.01 : Stimulation du potentiel technologique des PME (Action 2.1.4 - Chèques Technologiques)
SolAZ,11/02/2011,2500,750,1125,1875,750,1125,1875,21/04/2011,Mesure 2.01 : Stimulation du potentiel technologique des PME (Action 2.1.4 - Chèques Technologiques)
TAGEXPERT,21/03/2011,12000,3600,5400,9000,3600,5400,9000,21/06/2011,Mesure 2.01 : Stimulation du potentiel technologique des PME (Action 2.1.4 - Chèques Technologiques)
LESSINES INDUSTRIES,16/02/2011,500,150,225,375,150,225,375,16/03/2011,Mesure 2.01 : Stimulation du potentiel technologique des PME (Action 2.1.4 - Chèques Technologiques)
WEBVEILLE,11/03/2011,12000,3600,5400,9000,3600,5400,9000,29/09/2011,Mesure 2.01 : Stimulation du potentiel technologique des PME (Action 2.1.4 - Chèques Technologiques)
Uniteq,04/04/2011,4000,1200,1800,3000,1200,1800,3000,22/12/2011,Mesure 2.01 : Stimulation du potentiel technologique des PME (Action 2.1.4 - Chèques Technologiques)
BRIQUETERIES DE PLOEGSTEERT,28/03/2011,1500,450,675,1125,450,675,1125,08/06/2011,Mesure 2.01 : Stimulation du potentiel technologique des PME (Action 2.1.4 - Chèques Technologiques)
SERVICES PROSPECTIONS VENTES,25/03/2011,5500,1650,2475,4125,1050,1575,2625,8/12/2011,Mesure 2.01 : Stimulation du potentiel technologique des PME (Action 2.1.4 - Chèques Technologiques)
INTERSYSTO,04/04/2011,7500,2250,3375,5625,2250,3375,5625,14/12/2011,Mesure 2.01 : Stimulation du potentiel technologique des PME (Action 2.1.4 - Chèques Technologiques)
COVERFIL,14/04/2011,3500,1050,1575,2625,1050,1575,2625,27/04/2012,Mesure 2.01 : Stimulation du potentiel technologique des PME (Action 2.1.4 - Chèques Technologiques)
Marcel HALLOIN,18/04/2011,3500,1050,1575,2625,1050,1575,2625,23/11/2012,Mesure 2.01 : Stimulation du potentiel technologique des PME (Action 2.1.4 - Chèques Technologiques)
MALEX,18/05/2011,19500,5850,8775,14625,5850,8775,14625,10/10/2012,Mesure 2.01 : Stimulation du potentiel technologique des PME (Action 2.1.4 - Chèques Technologiques)
TAGEXPERT,27/05/2011,8000,2400,3600,6000,2400,3600,6000,29/06/2011,Mesure 2.01 : Stimulation du potentiel technologique des PME (Action 2.1.4 - Chèques Technologiques)
NEOCERAM,05/05/2011,20000,6000,9000,15000,6000,9000,15000,22/02/2012,Mesure 2.01 : Stimulation du potentiel technologique des PME (Action 2.1.4 - Chèques Technologiques)
ENERBAN,10/05/2011,20000,6000,9000,15000,6000,9000,15000,01/09/2011,Mesure 2.01 : Stimulation du potentiel technologique des PME (Action 2.1.4 - Chèques Technologiques)
CERSA,14/10/2011,1000,300,450,750,300,450,750,22/12/2011,Mesure 2.01 : Stimulation du potentiel technologique des PME (Action 2.1.4 - Chèques Technologiques)
DEXSIL LABS,18/05/2011,4000,1200,1800,3000,1200,1800,3000,29/09/2011,Mesure 2.01 : Stimulation du potentiel technologique des PME (Action 2.1.4 - Chèques Technologiques)
LASER COATING DIAMOND TECHNOLOGY,18/05/2011,10000,3000,4500,7500,3000,4500,7500,8/12/2011,Mesure 2.01 : Stimulation du potentiel technologique des PME (Action 2.1.4 - Chèques Technologiques)
INTERSYSTO,30/05/2011,12000,3600,5400,9000,3600,5400,9000,23/08/2012,Mesure 2.01 : Stimulation du potentiel technologique des PME (Action 2.1.4 - Chèques Technologiques)
KOLLECTOR,31/05/2011,20000,6000,9000,15000,6000,9000,15000,08/07/2011,Mesure 2.01 : Stimulation du potentiel technologique des PME (Action 2.1.4 - Chèques Technologiques)
FOOD PARTNERS CO,06/06/2011,2000,600,900,1500,600,900,1500,26/08/2011,Mesure 2.01 : Stimulation du potentiel technologique des PME (Action 2.1.4 - Chèques Technologiques)
Brasserie Mynsbrughen et de Silly,22/06/2011,1000,300,450,750,300,450,750,10/04/2012,Mesure 2.01 : Stimulation du potentiel technologique des PME (Action 2.1.4 - Chèques Technologiques)
METAL QUARTZ,08/08/2011,1000,300,450,750,300,450,750,14/12/2011,Mesure 2.01 : Stimulation du potentiel technologique des PME (Action 2.1.4 - Chèques Technologiques)
LEBAILLY,21/06/2011,17500,5250,7875,13125,5250,7875,13125,17/05/2013,Mesure 2.01 : Stimulation du potentiel technologique des PME (Action 2.1.4 - Chèques Technologiques)
THERMIBEL,19/07/2011,3000,900,1350,2250,900,1350,2250,29/06/2012,Mesure 2.01 : Stimulation du potentiel technologique des PME (Action 2.1.4 - Chèques Technologiques)
CROC'IN,20/06/2011,500,150,225,375,150,225,375,01/09/2011,Mesure 2.01 : Stimulation du potentiel technologique des PME (Action 2.1.4 - Chèques Technologiques)
Repamine,24/06/2011,3000,900,1350,2250,900,1350,2250,30/09/2011,Mesure 2.01 : Stimulation du potentiel technologique des PME (Action 2.1.4 - Chèques Technologiques)
A-M-B- CONSTRUCT,21/06/2011,5000,1500,2250,3750,1500,2250,3750,18/11/2011,Mesure 2.01 : Stimulation du potentiel technologique des PME (Action 2.1.4 - Chèques Technologiques)
SOCIETE COMINOISE DE MAILLE INDUSTRIELLE,21/06/2011,10000,3000,4500,7500,3000,4500,7500,11/10/2013,Mesure 2.01 : Stimulation du potentiel technologique des PME (Action 2.1.4 - Chèques Technologiques)
SOCIETE COMINOISE DE MAILLE INDUSTRIELLE,27/06/2011,8000,2400,3600,6000,2400,3600,6000,15/03/2012,Mesure 2.01 : Stimulation du potentiel technologique des PME (Action 2.1.4 - Chèques Technologiques)
REVER,27/06/2011,12000,3600,5400,9000,2250,3375,5625,8/12/2011,Mesure 2.01 : Stimulation du potentiel technologique des PME (Action 2.1.4 - Chèques Technologiques)
SOCIETE BELGE D'INFORMATIQUE MEDICALE,28/06/2011,10000,3000,4500,7500,1350,2025,3375,13/05/2013,Mesure 2.01 : Stimulation du potentiel technologique des PME (Action 2.1.4 - Chèques Technologiques)
ASSOCIATION INFORMATIQUE POUR LA GESTION DULOGEMENT SOCIAL,28/06/2011,8000,2400,3600,6000,1950,2925,4875,26/08/2011,Mesure 2.01 : Stimulation du potentiel technologique des PME (Action 2.1.4 - Chèques Technologiques)
A.M.B.,07/07/2011,8500,2550,3825,6375,2550,3825,6375,18/04/2013,Mesure 2.01 : Stimulation du potentiel technologique des PME (Action 2.1.4 - Chèques Technologiques)
CASTEL ENGINEERING,06/07/2011,7000,2100,3150,5250,2100,3150,5250,04/07/2014,Mesure 2.01 : Stimulation du potentiel technologique des PME (Action 2.1.4 - Chèques Technologiques)
LES CARRIERES DE LA PIERRE BLEUE BELGE ,08/07/2011,8500,2550,3825,6375,2550,3825,6375,30/05/2012,Mesure 2.01 : Stimulation du potentiel technologique des PME (Action 2.1.4 - Chèques Technologiques)
LESSINES INDUSTRIES,11/07/2011,1000,300,450,750,300,450,750,14/12/2011,Mesure 2.01 : Stimulation du potentiel technologique des PME (Action 2.1.4 - Chèques Technologiques)
LESSINES INDUSTRIES,11/07/2011,1500,450,675,1125,450,675,1125,29/08/2011,Mesure 2.01 : Stimulation du potentiel technologique des PME (Action 2.1.4 - Chèques Technologiques)
BEADS BELGIUM,11/07/2011,20000,6000,9000,15000,6000,9000,15000,8/12/2011,Mesure 2.01 : Stimulation du potentiel technologique des PME (Action 2.1.4 - Chèques Technologiques)
HAPPY PAPER,11/07/2011,1500,450,675,1125,450,675,1125,24/04/2012,Mesure 2.01 : Stimulation du potentiel technologique des PME (Action 2.1.4 - Chèques Technologiques)
MUZYTRIBE,14/07/2011,20000,6000,9000,15000,3450,5175,8625,11/10/2011,Mesure 2.01 : Stimulation du potentiel technologique des PME (Action 2.1.4 - Chèques Technologiques)
ROLPH & ROLPH,19/07/2011,1000,300,450,750,300,450,750,09/09/2011,Mesure 2.01 : Stimulation du potentiel technologique des PME (Action 2.1.4 - Chèques Technologiques)
MOLIERE ET COMPAGNIE,27/07/2011,5000,1500,2250,3750,450,675,1125,26/09/2012,Mesure 2.01 : Stimulation du potentiel technologique des PME (Action 2.1.4 - Chèques Technologiques)
Les Produits Purs de Courcelles,11/10/2011,20000,6000,9000,15000,6000,9000,15000,06/03/2012,Mesure 2.01 : Stimulation du potentiel technologique des PME (Action 2.1.4 - Chèques Technologiques)
Etablissements Jarilux,29/07/2011,4000,1200,1800,3000,1200,1800,3000,14/02/2012,Mesure 2.01 : Stimulation du potentiel technologique des PME (Action 2.1.4 - Chèques Technologiques)
ADVACHEM,11/08/2011,20000,6000,9000,15000,6000,9000,15000,14/09/2012,Mesure 2.01 : Stimulation du potentiel technologique des PME (Action 2.1.4 - Chèques Technologiques)
Exdere,16/08/2011,500,150,225,375,150,225,375,3/11/2011,Mesure 2.01 : Stimulation du potentiel technologique des PME (Action 2.1.4 - Chèques Technologiques)
WEBVEILLE,18/08/2011,3000,900,1350,2250,900,1350,2250,8/12/2011,Mesure 2.01 : Stimulation du potentiel technologique des PME (Action 2.1.4 - Chèques Technologiques)
Sucrerie Couplet,24/08/2011,1500,450,675,1125,450,675,1125,22/12/2011,Mesure 2.01 : Stimulation du potentiel technologique des PME (Action 2.1.4 - Chèques Technologiques)
Industrial Consulting Automation Research Engineering,13/09/2011,20000,6000,9000,15000,6000,9000,15000,06/01/2012,Mesure 2.01 : Stimulation du potentiel technologique des PME (Action 2.1.4 - Chèques Technologiques)
LESSINES INDUSTRIES,12/09/2011,500,150,225,375,150,225,375,3/11/2011,Mesure 2.01 : Stimulation du potentiel technologique des PME (Action 2.1.4 - Chèques Technologiques)
Kiwi Engineering,15/09/2011,1000,300,450,750,300,450,750,18/11/2011,Mesure 2.01 : Stimulation du potentiel technologique des PME (Action 2.1.4 - Chèques Technologiques)
Etablissements Lixon,23/09/2011,1000,300,450,750,300,450,750,07/06/2012,Mesure 2.01 : Stimulation du potentiel technologique des PME (Action 2.1.4 - Chèques Technologiques)
PRODUCTION INDUSTRIELLE PHIL DESIGN STUDIO,4/10/2011,12500,3750,5625,9375,3750,5625,9375,14/07/2014,Mesure 2.01 : Stimulation du potentiel technologique des PME (Action 2.1.4 - Chèques Technologiques)
SENIORIMMO,27/09/2011,7500,2250,3375,5625,2250,3375,5625,04/07/2014,Mesure 2.01 : Stimulation du potentiel technologique des PME (Action 2.1.4 - Chèques Technologiques)
BARTEX,27/09/2011,1500,450,675,1125,450,675,1125,15/03/2012,Mesure 2.01 : Stimulation du potentiel technologique des PME (Action 2.1.4 - Chèques Technologiques)
L.R. VITRAUX,1/10/2011,4000,1200,1800,3000,1200,1800,3000,23/08/2012,Mesure 2.01 : Stimulation du potentiel technologique des PME (Action 2.1.4 - Chèques Technologiques)
GREEN2CHEM CONSULTING,6/10/2011,20000,6000,9000,15000,6000,9000,15000,30/11/2012,Mesure 2.01 : Stimulation du potentiel technologique des PME (Action 2.1.4 - Chèques Technologiques)
DICO SERVICE,12/10/2011,20000,6000,9000,15000,4050,6075,10125,23/08/2013,Mesure 2.01 : Stimulation du potentiel technologique des PME (Action 2.1.4 - Chèques Technologiques)
ECOFROST,14/10/2011,13500,4050,6075,10125,4050,6075,10125,22/12/2011,Mesure 2.01 : Stimulation du potentiel technologique des PME (Action 2.1.4 - Chèques Technologiques)
D. - TEK,14/10/2011,20000,6000,9000,15000,6000,9000,15000,5/12/2012,Mesure 2.01 : Stimulation du potentiel technologique des PME (Action 2.1.4 - Chèques Technologiques)
FOOD INGREDIENTS TECHNOLOGIES,25/10/2011,2000,600,900,1500,600,900,1500,30/12/2011,Mesure 2.01 : Stimulation du potentiel technologique des PME (Action 2.1.4 - Chèques Technologiques)
SENTINALCO,3/11/2011,4000,1200,1800,3000,1200,1800,3000,10/04/2012,Mesure 2.01 : Stimulation du potentiel technologique des PME (Action 2.1.4 - Chèques Technologiques)
Marcel HALLOIN,14/11/2011,3000,900,1350,2250,900,1350,2250,22/02/2012,Mesure 2.01 : Stimulation du potentiel technologique des PME (Action 2.1.4 - Chèques Technologiques)
COVER GROUP,7/11/2011,18500,5550,8325,13875,5550,8325,13875,28/06/2012,Mesure 2.01 : Stimulation du potentiel technologique des PME (Action 2.1.4 - Chèques Technologiques)
DEXSIL LABS,23/11/2011,1000,300,450,750,300,450,750,14/02/2012,Mesure 2.01 : Stimulation du potentiel technologique des PME (Action 2.1.4 - Chèques Technologiques)
RECOVAL BELGIUM,9/12/2011,3500,1050,1575,2625,1050,1575,2625,08/01/2013,Mesure 2.01 : Stimulation du potentiel technologique des PME (Action 2.1.4 - Chèques Technologiques)
RECOVAL BELGIUM,9/12/2011,4000,1200,1800,3000,1200,1800,3000,10/10/2012,Mesure 2.01 : Stimulation du potentiel technologique des PME (Action 2.1.4 - Chèques Technologiques)
TECHNICHEM,16/12/2011,5000,1500,2250,3750,1500,2250,3750,15/03/2012,Mesure 2.01 : Stimulation du potentiel technologique des PME (Action 2.1.4 - Chèques Technologiques)
A-M-B- CONSTRUCT,16/12/2011,15000,4500,6750,11250,4500,6750,11250,17/05/2013,Mesure 2.01 : Stimulation du potentiel technologique des PME (Action 2.1.4 - Chèques Technologiques)
Marcel HALLOIN,14/12/2011,1500,450,675,1125,450,675,1125,29/06/2012,Mesure 2.01 : Stimulation du potentiel technologique des PME (Action 2.1.4 - Chèques Technologiques)
ENTREPRISE BORAINE DE MECANIQUE,16/12/2011,9000,2700,4050,6750,2700,4050,6750,5/12/2012,Mesure 2.01 : Stimulation du potentiel technologique des PME (Action 2.1.4 - Chèques Technologiques)
SGTC - Société Générale de Technique et de Commerce,15/12/2011,5000,1500,2250,3750,1500,2250,3750,27/04/2012,Mesure 2.01 : Stimulation du potentiel technologique des PME (Action 2.1.4 - Chèques Technologiques)
BIZZDEV,15/12/2011,20000,6000,9000,15000,6000,9000,15000,13/06/2013,Mesure 2.01 : Stimulation du potentiel technologique des PME (Action 2.1.4 - Chèques Technologiques)
it4ip,16/12/2011,2000,600,900,1500,600,900,1500,25/04/2012,Mesure 2.01 : Stimulation du potentiel technologique des PME (Action 2.1.4 - Chèques Technologiques)
SILVER RAY,22/12/2011,19500,5850,8775,14625,5850,8775,14625,20/12/2012,Mesure 2.01 : Stimulation du potentiel technologique des PME (Action 2.1.4 - Chèques Technologiques)
PLASTISERVICE,23/12/2011,5000,1500,2250,3750,1500,2250,3750,21/12/2012,Mesure 2.01 : Stimulation du potentiel technologique des PME (Action 2.1.4 - Chèques Technologiques)
PLASTISERVICE,23/12/2011,10000,3000,4500,7500,3000,4500,7500,18/12/2013,Mesure 2.01 : Stimulation du potentiel technologique des PME (Action 2.1.4 - Chèques Technologiques)
MEDESTIME,05/01/2012,3500,1050,1575,2625,1050,1575,2625,19/09/2014,Mesure 2.01 : Stimulation du potentiel technologique des PME (Action 2.1.4 - Chèques Technologiques)
VERSCHUERE TECHNOLOGY,23/12/2011,18000,5400,8100,13500,5400,8100,13500,14/07/2014,Mesure 2.01 : Stimulation du potentiel technologique des PME (Action 2.1.4 - Chèques Technologiques)
ISONEXT,23/12/2011,19000,5700,8550,14250,600,900,1500,31/10/2012,Mesure 2.01 : Stimulation du potentiel technologique des PME (Action 2.1.4 - Chèques Technologiques)
FOOTIIS,20/04/2012,4000,1200,1800,3000,1200,1800,3000,28/06/2012,Mesure 2.01 : Stimulation du potentiel technologique des PME (Action 2.1.4 - Chèques Technologiques)
LESSINES INDUSTRIES,11/01/2012,1000,300,450,750,300,450,750,14/02/2012,Mesure 2.01 : Stimulation du potentiel technologique des PME (Action 2.1.4 - Chèques Technologiques)
Kiwi Engineering,13/01/2012,2000,600,900,1500,600,900,1500,30/03/2012,Mesure 2.01 : Stimulation du potentiel technologique des PME (Action 2.1.4 - Chèques Technologiques)
LESSINES INDUSTRIES,26/01/2012,1000,300,450,750,300,450,750,23/02/2012,Mesure 2.01 : Stimulation du potentiel technologique des PME (Action 2.1.4 - Chèques Technologiques)
PRECIS SELECT,09/02/2012,1500,450,675,1125,450,675,1125,24/04/2012,Mesure 2.01 : Stimulation du potentiel technologique des PME (Action 2.1.4 - Chèques Technologiques)
Etablissements Jarilux,15/02/2012,4000,1200,1800,3000,1200,1800,3000,10/10/2012,Mesure 2.01 : Stimulation du potentiel technologique des PME (Action 2.1.4 - Chèques Technologiques)
LASER COATING DIAMOND TECHNOLOGY,01/03/2012,11000,3300,4950,8250,3300,4950,8250,18/04/2013,Mesure 2.01 : Stimulation du potentiel technologique des PME (Action 2.1.4 - Chèques Technologiques)
FOOD INGREDIENTS TECHNOLOGIES,07/03/2012,3000,900,1350,2250,900,1350,2250,30/05/2012,Mesure 2.01 : Stimulation du potentiel technologique des PME (Action 2.1.4 - Chèques Technologiques)
Calcaires de la Sambre,14/03/2012,20000,6000,9000,15000,6000,9000,15000,19/11/2013,Mesure 2.01 : Stimulation du potentiel technologique des PME (Action 2.1.4 - Chèques Technologiques)
FOOD INGREDIENTS TECHNOLOGIES,20/03/2012,1500,450,675,1125,450,675,1125,30/05/2012,Mesure 2.01 : Stimulation du potentiel technologique des PME (Action 2.1.4 - Chèques Technologiques)
ENERBAN,22/03/2012,20000,6000,9000,15000,6000,9000,15000,04/05/2012,Mesure 2.01 : Stimulation du potentiel technologique des PME (Action 2.1.4 - Chèques Technologiques)
BEADS BELGIUM,23/03/2012,20000,6000,9000,15000,6000,9000,15000,16/07/2013,Mesure 2.01 : Stimulation du potentiel technologique des PME (Action 2.1.4 - Chèques Technologiques)
OPTEC,05/04/2012,4500,1350,2025,3375,1350,2025,3375,20/12/2012,Mesure 2.01 : Stimulation du potentiel technologique des PME (Action 2.1.4 - Chèques Technologiques)
LESSINES INDUSTRIES,12/04/2012,2000,600,900,1500,600,900,1500,11/05/2012,Mesure 2.01 : Stimulation du potentiel technologique des PME (Action 2.1.4 - Chèques Technologiques)
DIAROTECH,18/04/2012,2000,600,900,1500,600,900,1500,25/01/2013,Mesure 2.01 : Stimulation du potentiel technologique des PME (Action 2.1.4 - Chèques Technologiques)
NEOCERAM,16/04/2012,20000,6000,9000,15000,6000,9000,15000,31/10/2012,Mesure 2.01 : Stimulation du potentiel technologique des PME (Action 2.1.4 - Chèques Technologiques)
MEUNIER GROUP,26/04/2012,500,150,225,375,150,225,375,11/05/2012,Mesure 2.01 : Stimulation du potentiel technologique des PME (Action 2.1.4 - Chèques Technologiques)
SENTINALCO,23/04/2012,2000,600,900,1500,600,900,1500,28/06/2012,Mesure 2.01 : Stimulation du potentiel technologique des PME (Action 2.1.4 - Chèques Technologiques)
FOOD INGREDIENTS TECHNOLOGIES,26/04/2012,4000,1200,1800,3000,1200,1800,3000,14/06/2013,Mesure 2.01 : Stimulation du potentiel technologique des PME (Action 2.1.4 - Chèques Technologiques)
RECOVAL BELGIUM,30/04/2012,8500,2550,3825,6375,2550,3825,6375,08/01/2013,Mesure 2.01 : Stimulation du potentiel technologique des PME (Action 2.1.4 - Chèques Technologiques)
GENIMIN,08/05/2012,4500,1350,2025,3375,450,675,1125,30/08/2012,Mesure 2.01 : Stimulation du potentiel technologique des PME (Action 2.1.4 - Chèques Technologiques)
PRECIS SELECT,29/05/2012,4500,1350,2025,3375,1350,2025,3375,23/08/2012,Mesure 2.01 : Stimulation du potentiel technologique des PME (Action 2.1.4 - Chèques Technologiques)
FOOD INGREDIENTS TECHNOLOGIES,30/05/2012,5500,1650,2475,4125,1650,2475,4125,14/06/2013,Mesure 2.01 : Stimulation du potentiel technologique des PME (Action 2.1.4 - Chèques Technologiques)
FOOD PARTNERS CO,19/06/2012,1500,450,675,1125,450,675,1125,14/09/2012,Mesure 2.01 : Stimulation du potentiel technologique des PME (Action 2.1.4 - Chèques Technologiques)
BELGARENA,26/06/2012,15000,4500,6750,11250,4500,6750,11250,24/09/2013,Mesure 2.01 : Stimulation du potentiel technologique des PME (Action 2.1.4 - Chèques Technologiques)
FOOTIIS,29/06/2012,13500,4050,6075,10125,4050,6075,10125,14/07/2014,Mesure 2.01 : Stimulation du potentiel technologique des PME (Action 2.1.4 - Chèques Technologiques)
HAPPY PAPER,28/06/2012,1000,300,450,750,300,450,750,31/08/2012,Mesure 2.01 : Stimulation du potentiel technologique des PME (Action 2.1.4 - Chèques Technologiques)
STI Consult,09/01/2013,2000,600,900,1500,600,900,1500,04/07/2014,Mesure 2.01 : Stimulation du potentiel technologique des PME (Action 2.1.4 - Chèques Technologiques)
Belvas,29/06/2012,8500,2550,3825,6375,2550,3825,6375,18/04/2013,Mesure 2.01 : Stimulation du potentiel technologique des PME (Action 2.1.4 - Chèques Technologiques)
BIOHAINAUT,02/07/2012,1500,450,675,1125,450,675,1125,10/10/2012,Mesure 2.01 : Stimulation du potentiel technologique des PME (Action 2.1.4 - Chèques Technologiques)
DEXSIL LABS,23/08/2012,16000,4800,7200,12000,4800,7200,12000,22/02/2013,Mesure 2.01 : Stimulation du potentiel technologique des PME (Action 2.1.4 - Chèques Technologiques)
ANTOING RECYCLAGE BETONS,11/07/2012,1500,450,675,1125,450,675,1125,22/10/2012,Mesure 2.01 : Stimulation du potentiel technologique des PME (Action 2.1.4 - Chèques Technologiques)
TECHNICHEM,11/09/2012,5500,1650,2475,4125,1650,2475,4125,25/01/2013,Mesure 2.01 : Stimulation du potentiel technologique des PME (Action 2.1.4 - Chèques Technologiques)
Marcel HALLOIN,16/07/2012,1000,300,450,750,300,450,750,27/02/2014,Mesure 2.01 : Stimulation du potentiel technologique des PME (Action 2.1.4 - Chèques Technologiques)
FOOD PARTNERS CO,24/07/2012,2000,600,900,1500,600,900,1500,5/12/2012,Mesure 2.01 : Stimulation du potentiel technologique des PME (Action 2.1.4 - Chèques Technologiques)
COMET TRAITEMENTS,27/07/2012,2500,750,1125,1875,750,1125,1875,22/10/2012,Mesure 2.01 : Stimulation du potentiel technologique des PME (Action 2.1.4 - Chèques Technologiques)
Etablissements Jarilux,25/07/2012,3500,1050,1575,2625,1050,1575,2625,22/02/2013,Mesure 2.01 : Stimulation du potentiel technologique des PME (Action 2.1.4 - Chèques Technologiques)
SOCIETE NOUVELLE HAINAUT CARLIER,08/08/2012,9500,2850,4275,7125,2850,4275,7125,04/04/2013,Mesure 2.01 : Stimulation du potentiel technologique des PME (Action 2.1.4 - Chèques Technologiques)
ECOFROST,13/08/2012,500,150,225,375,150,225,375,10/10/2012,Mesure 2.01 : Stimulation du potentiel technologique des PME (Action 2.1.4 - Chèques Technologiques)
BIOHAINAUT,14/08/2012,1000,300,450,750,300,450,750,31/10/2012,Mesure 2.01 : Stimulation du potentiel technologique des PME (Action 2.1.4 - Chèques Technologiques)
BIOHAINAUT,23/08/2012,1500,450,675,1125,450,675,1125,14/09/2012,Mesure 2.01 : Stimulation du potentiel technologique des PME (Action 2.1.4 - Chèques Technologiques)
THERMO 2000,07/09/2012,2500,750,1125,1875,750,1125,1875,08/03/2013,Mesure 2.01 : Stimulation du potentiel technologique des PME (Action 2.1.4 - Chèques Technologiques)
COMET TRAITEMENTS,29/08/2012,2000,600,900,1500,600,900,1500,22/10/2012,Mesure 2.01 : Stimulation du potentiel technologique des PME (Action 2.1.4 - Chèques Technologiques)
Escavèche du Clos Normand,12/09/2012,500,150,225,375,150,225,375,20/11/2012,Mesure 2.01 : Stimulation du potentiel technologique des PME (Action 2.1.4 - Chèques Technologiques)
EUROCOVER,04/09/2012,15000,4500,6750,11250,4500,6750,11250,17/05/2013,Mesure 2.01 : Stimulation du potentiel technologique des PME (Action 2.1.4 - Chèques Technologiques)
AL CONCEPT,04/09/2012,9500,2850,4275,7125,2850,4275,7125,14/07/2014,Mesure 2.01 : Stimulation du potentiel technologique des PME (Action 2.1.4 - Chèques Technologiques)
SPYTANK,14/09/2012,2000,600,900,1500,600,900,1500,14/07/2014,Mesure 2.01 : Stimulation du potentiel technologique des PME (Action 2.1.4 - Chèques Technologiques)
Desobry,11/09/2012,18000,5400,8100,13500,5400,8100,13500,30/11/2012,Mesure 2.01 : Stimulation du potentiel technologique des PME (Action 2.1.4 - Chèques Technologiques)
IMMOROUTE,10/09/2012,1500,450,675,1125,450,675,1125,08/03/2013,Mesure 2.01 : Stimulation du potentiel technologique des PME (Action 2.1.4 - Chèques Technologiques)
IMMOROUTE,10/09/2012,11500,3450,5175,8625,3450,5175,8625,5/11/2013,Mesure 2.01 : Stimulation du potentiel technologique des PME (Action 2.1.4 - Chèques Technologiques)
RA CONCEPT,12/09/2012,18500,5550,8325,13875,5550,8325,13875,22/05/2013,Mesure 2.01 : Stimulation du potentiel technologique des PME (Action 2.1.4 - Chèques Technologiques)
MASTHERCELL,19/09/2012,7000,2100,3150,5250,2100,3150,5250,13/12/2012,Mesure 2.01 : Stimulation du potentiel technologique des PME (Action 2.1.4 - Chèques Technologiques)
MEDESTIME,27/09/2012,3000,900,1350,2250,900,1350,2250,14/07/2014,Mesure 2.01 : Stimulation du potentiel technologique des PME (Action 2.1.4 - Chèques Technologiques)
NEG - Nouveaux Entrepôts et Garages,16/10/2012,15000,4500,6750,11250,2700,4050,6750,08/04/2014,Mesure 2.01 : Stimulation du potentiel technologique des PME (Action 2.1.4 - Chèques Technologiques)
COMET TRAITEMENTS,26/09/2012,1500,450,675,1125,450,675,1125,22/10/2012,Mesure 2.01 : Stimulation du potentiel technologique des PME (Action 2.1.4 - Chèques Technologiques)
FOOTIIS,3/10/2012,4000,1200,1800,3000,1200,1800,3000,14/07/2014,Mesure 2.01 : Stimulation du potentiel technologique des PME (Action 2.1.4 - Chèques Technologiques)
PRYME INVEST,1/10/2012,2000,600,900,1500,600,900,1500,5/12/2012,Mesure 2.01 : Stimulation du potentiel technologique des PME (Action 2.1.4 - Chèques Technologiques)
DVL _ K,25/01/2013,1500,450,675,1125,450,675,1125,08/09/2014,Mesure 2.01 : Stimulation du potentiel technologique des PME (Action 2.1.4 - Chèques Technologiques)
PRODUCTION INDUSTRIELLE PHIL DESIGN STUDIO,17/10/2012,3000,900,1350,2250,900,1350,2250,08/09/2014,Mesure 2.01 : Stimulation du potentiel technologique des PME (Action 2.1.4 - Chèques Technologiques)
CARDONE INDUSTRIES EUROPE,10/01/2013,6000,1800,2700,4500,1800,2700,4500,16/07/2013,Mesure 2.01 : Stimulation du potentiel technologique des PME (Action 2.1.4 - Chèques Technologiques)
ACIC,22/10/2012,20000,6000,9000,15000,6000,9000,15000,05/02/2013,Mesure 2.01 : Stimulation du potentiel technologique des PME (Action 2.1.4 - Chèques Technologiques)
ALPINTER,15/10/2012,20000,6000,9000,15000,6000,9000,15000,18/12/2013,Mesure 2.01 : Stimulation du potentiel technologique des PME (Action 2.1.4 - Chèques Technologiques)
TOTAL SALES SOLUTIONS IN THE FIELD,12/10/2012,8000,2400,3600,6000,1500,2250,3750,5/11/2013,Mesure 2.01 : Stimulation du potentiel technologique des PME (Action 2.1.4 - Chèques Technologiques)
MEDESTIME,19/10/2012,2000,600,900,1500,600,900,1500,04/07/2014,Mesure 2.01 : Stimulation du potentiel technologique des PME (Action 2.1.4 - Chèques Technologiques)
CARESQUARE,23/10/2012,20000,6000,9000,15000,6000,9000,15000,13/12/2012,Mesure 2.01 : Stimulation du potentiel technologique des PME (Action 2.1.4 - Chèques Technologiques)
SPYTANK,24/10/2012,8500,2550,3825,6375,2550,3825,6375,08/03/2013,Mesure 2.01 : Stimulation du potentiel technologique des PME (Action 2.1.4 - Chèques Technologiques)
URBA - STYLE,24/10/2012,7000,2100,3150,5250,2100,3150,5250,25/06/2013,Mesure 2.01 : Stimulation du potentiel technologique des PME (Action 2.1.4 - Chèques Technologiques)
HYDROPROTECT,25/10/2012,1500,450,675,1125,450,675,1125,14/07/2014,Mesure 2.01 : Stimulation du potentiel technologique des PME (Action 2.1.4 - Chèques Technologiques)
IMMO - LABO,25/10/2012,20000,6000,9000,15000,6000,9000,15000,11/04/2014,Mesure 2.01 : Stimulation du potentiel technologique des PME (Action 2.1.4 - Chèques Technologiques)
H.O.P.,22/11/2012,20000,6000,9000,15000,6000,9000,15000,09/04/2013,Mesure 2.01 : Stimulation du potentiel technologique des PME (Action 2.1.4 - Chèques Technologiques)
TECHNICHEM,21/11/2012,2000,600,900,1500,600,900,1500,31/03/2014,Mesure 2.01 : Stimulation du potentiel technologique des PME (Action 2.1.4 - Chèques Technologiques)
ETABLISSEMENTS ROBERT STIERNON,28/11/2012,9500,2850,4275,7125,2850,4275,7125,08/03/2013,Mesure 2.01 : Stimulation du potentiel technologique des PME (Action 2.1.4 - Chèques Technologiques)
Les Produits Purs de Courcelles,13/12/2012,5000,1500,2250,3750,1500,2250,3750,27/02/2014,Mesure 2.01 : Stimulation du potentiel technologique des PME (Action 2.1.4 - Chèques Technologiques)
Les Produits Purs de Courcelles,13/12/2012,1000,300,450,750,300,450,750,30/04/2013,Mesure 2.01 : Stimulation du potentiel technologique des PME (Action 2.1.4 - Chèques Technologiques)
LE TISSAGE D'ARCADE,25/02/2013,2000,600,900,1500,600,900,1500,07/06/2013,Mesure 2.01 : Stimulation du potentiel technologique des PME (Action 2.1.4 - Chèques Technologiques)
SPYTANK,17/12/2012,500,150,225,375,150,225,375,04/07/2014,Mesure 2.01 : Stimulation du potentiel technologique des PME (Action 2.1.4 - Chèques Technologiques)
BIOHAINAUT,17/12/2012,2500,750,1125,1875,750,1125,1875,22/02/2013,Mesure 2.01 : Stimulation du potentiel technologique des PME (Action 2.1.4 - Chèques Technologiques)
Belvas,17/12/2012,6500,1950,2925,4875,1950,2925,4875,19/11/2013,Mesure 2.01 : Stimulation du potentiel technologique des PME (Action 2.1.4 - Chèques Technologiques)
THERMIBEL,17/12/2012,1500,450,675,1125,450,675,1125,22/05/2013,Mesure 2.01 : Stimulation du potentiel technologique des PME (Action 2.1.4 - Chèques Technologiques)
ECOPLAST TECHNOLOGY,3/12/2013,8000,2400,3600,6000,2400,3600,6000,27/07/2015,Mesure 2.01 : Stimulation du potentiel technologique des PME (Action 2.1.4 - Chèques Technologiques)
TECHNICHEM,10/01/2013,1500,450,675,1125,450,675,1125,02/04/2013,Mesure 2.01 : Stimulation du potentiel technologique des PME (Action 2.1.4 - Chèques Technologiques)
DE POORTERE FRERES,18/12/2012,12000,3600,5400,9000,3600,5400,9000,13/11/2015,Mesure 2.01 : Stimulation du potentiel technologique des PME (Action 2.1.4 - Chèques Technologiques)
COMET TRAITEMENTS,20/12/2012,4500,1350,2025,3375,1350,2025,3375,16/05/2014,Mesure 2.01 : Stimulation du potentiel technologique des PME (Action 2.1.4 - Chèques Technologiques)
AGROFUTUR,17/01/2013,20000,6000,9000,15000,6000,9000,15000,14/07/2014,Mesure 2.01 : Stimulation du potentiel technologique des PME (Action 2.1.4 - Chèques Technologiques)
SALUC,21/12/2012,1000,300,450,750,300,450,750,16/04/2013,Mesure 2.01 : Stimulation du potentiel technologique des PME (Action 2.1.4 - Chèques Technologiques)
PLASTISERVICE,21/12/2012,10000,3000,4500,7500,3000,4500,7500,18/12/2013,Mesure 2.01 : Stimulation du potentiel technologique des PME (Action 2.1.4 - Chèques Technologiques)
I-MOVIX,26/12/2012,14000,4200,6300,10500,4200,6300,10500,03/07/2013,Mesure 2.01 : Stimulation du potentiel technologique des PME (Action 2.1.4 - Chèques Technologiques)
DECOCK YOUNGPLANTS,14/01/2013,5000,1500,2250,3750,1500,2250,3750,5/11/2013,Mesure 2.01 : Stimulation du potentiel technologique des PME (Action 2.1.4 - Chèques Technologiques)
D. - TEK,5/11/2014,20000,6000,9000,15000,6000,9000,15000,20/02/2015,Mesure 2.01 : Stimulation du potentiel technologique des PME (Action 2.1.4 - Chèques Technologiques)
DELPHI GENETICS,07/02/2013,500,150,225,375,150,225,375,25/06/2013,Mesure 2.01 : Stimulation du potentiel technologique des PME (Action 2.1.4 - Chèques Technologiques)
LES ATELIERS DE BLICQUY,30/01/2013,500,150,225,375,150,225,375,22/02/2013,Mesure 2.01 : Stimulation du potentiel technologique des PME (Action 2.1.4 - Chèques Technologiques)
ENERBAN,12/02/2013,20000,6000,9000,15000,6000,9000,15000,16/04/2013,Mesure 2.01 : Stimulation du potentiel technologique des PME (Action 2.1.4 - Chèques Technologiques)
it4ip,13/02/2013,1500,450,675,1125,450,675,1125,09/04/2013,Mesure 2.01 : Stimulation du potentiel technologique des PME (Action 2.1.4 - Chèques Technologiques)
N.T.,14/02/2013,10000,3000,4500,7500,3000,4500,7500,17/05/2013,Mesure 2.01 : Stimulation du potentiel technologique des PME (Action 2.1.4 - Chèques Technologiques)
AL CONCEPT,19/02/2013,3000,900,1350,2250,900,1350,2250,19/09/2014,Mesure 2.01 : Stimulation du potentiel technologique des PME (Action 2.1.4 - Chèques Technologiques)
LFC,25/02/2013,500,150,225,375,150,225,375,09/04/2013,Mesure 2.01 : Stimulation du potentiel technologique des PME (Action 2.1.4 - Chèques Technologiques)
HERE NOW & MANAGEMENT,16/02/2013,20000,6000,9000,15000,6000,9000,15000,25/07/2013,Mesure 2.01 : Stimulation du potentiel technologique des PME (Action 2.1.4 - Chèques Technologiques)
DEXSIL LABS,14/03/2013,3000,900,1350,2250,900,1350,2250,18/04/2013,Mesure 2.01 : Stimulation du potentiel technologique des PME (Action 2.1.4 - Chèques Technologiques)
RECOVAL BELGIUM,20/02/2013,4000,1200,1800,3000,1200,1800,3000,05/07/2013,Mesure 2.01 : Stimulation du potentiel technologique des PME (Action 2.1.4 - Chèques Technologiques)
Etablissements Jarilux,22/02/2013,4000,1200,1800,3000,1200,1800,3000,16/07/2013,Mesure 2.01 : Stimulation du potentiel technologique des PME (Action 2.1.4 - Chèques Technologiques)
THERMO 2000,14/03/2013,2000,600,900,1500,600,900,1500,07/06/2013,Mesure 2.01 : Stimulation du potentiel technologique des PME (Action 2.1.4 - Chèques Technologiques)
GREEN2CHEM CONSULTING,05/03/2013,8500,2550,3825,6375,2550,3825,6375,31/03/2014,Mesure 2.01 : Stimulation du potentiel technologique des PME (Action 2.1.4 - Chèques Technologiques)
IMMOROUTE,11/03/2013,8000,2400,3600,6000,2400,3600,6000,18/12/2013,Mesure 2.01 : Stimulation du potentiel technologique des PME (Action 2.1.4 - Chèques Technologiques)
SPYTANK,12/03/2013,17500,5250,7875,13125,5250,7875,13125,21/08/2013,Mesure 2.01 : Stimulation du potentiel technologique des PME (Action 2.1.4 - Chèques Technologiques)
DELPHI GENETICS,13/03/2013,5000,1500,2250,3750,1500,2250,3750,24/12/2013,Mesure 2.01 : Stimulation du potentiel technologique des PME (Action 2.1.4 - Chèques Technologiques)
VALORE,14/03/2013,3000,900,1350,2250,900,1350,2250,19/11/2013,Mesure 2.01 : Stimulation du potentiel technologique des PME (Action 2.1.4 - Chèques Technologiques)
VALORE,15/03/2013,15500,4650,6975,11625,4650,6975,11625,5/11/2013,Mesure 2.01 : Stimulation du potentiel technologique des PME (Action 2.1.4 - Chèques Technologiques)
METAL QUARTZ,14/08/2013,1000,300,450,750,300,450,750,11/03/2014,Mesure 2.01 : Stimulation du potentiel technologique des PME (Action 2.1.4 - Chèques Technologiques)
MEDESTIME,29/03/2013,2500,750,1125,1875,750,1125,1875,08/09/2014,Mesure 2.01 : Stimulation du potentiel technologique des PME (Action 2.1.4 - Chèques Technologiques)
TECHNICHEM,22/08/2013,2500,750,1125,1875,750,1125,1875,31/03/2014,Mesure 2.01 : Stimulation du potentiel technologique des PME (Action 2.1.4 - Chèques Technologiques)
BAKBEL EUROPE,04/04/2013,4000,1200,1800,3000,1200,1800,3000,16/05/2014,Mesure 2.01 : Stimulation du potentiel technologique des PME (Action 2.1.4 - Chèques Technologiques)
TECHNICHEM,22/08/2013,6000,1800,2700,4500,1800,2700,4500,16/05/2014,Mesure 2.01 : Stimulation du potentiel technologique des PME (Action 2.1.4 - Chèques Technologiques)
FOOTIIS,25/04/2013,2000,600,900,1500,150,225,375,14/02/2014,Mesure 2.01 : Stimulation du potentiel technologique des PME (Action 2.1.4 - Chèques Technologiques)
Escavèche du Clos Normand,13/05/2013,2000,600,900,1500,600,900,1500,28/10/2014,Mesure 2.01 : Stimulation du potentiel technologique des PME (Action 2.1.4 - Chèques Technologiques)
Brasserie Dubuisson fréres,06/05/2013,10000,3000,4500,7500,3000,4500,7500,08/04/2014,Mesure 2.01 : Stimulation du potentiel technologique des PME (Action 2.1.4 - Chèques Technologiques)
OXYLENT,07/05/2013,3000,900,1350,2250,900,1350,2250,03/09/2013,Mesure 2.01 : Stimulation du potentiel technologique des PME (Action 2.1.4 - Chèques Technologiques)
H.O.P.,08/05/2013,7500,2250,3375,5625,2250,3375,5625,5/11/2013,Mesure 2.01 : Stimulation du potentiel technologique des PME (Action 2.1.4 - Chèques Technologiques)
OncoDNA,13/05/2013,20000,6000,9000,15000,6000,9000,15000,16/05/2014,Mesure 2.01 : Stimulation du potentiel technologique des PME (Action 2.1.4 - Chèques Technologiques)
COVERFIL,17/06/2013,1000,300,450,750,300,450,750,16/07/2013,Mesure 2.01 : Stimulation du potentiel technologique des PME (Action 2.1.4 - Chèques Technologiques)
H.O.P.,23/05/2013,4000,1200,1800,3000,1200,1800,3000,24/09/2013,Mesure 2.01 : Stimulation du potentiel technologique des PME (Action 2.1.4 - Chèques Technologiques)
Grandes Distilleries de Charleroi,05/06/2013,500,150,225,375,150,225,375,25/07/2013,Mesure 2.01 : Stimulation du potentiel technologique des PME (Action 2.1.4 - Chèques Technologiques)
ROOSENS BETONS,12/06/2013,1000,300,450,750,300,450,750,14/02/2014,Mesure 2.01 : Stimulation du potentiel technologique des PME (Action 2.1.4 - Chèques Technologiques)
SIFACO BENELUX,07/06/2013,10000,3000,4500,7500,3000,4500,7500,21/08/2013,Mesure 2.01 : Stimulation du potentiel technologique des PME (Action 2.1.4 - Chèques Technologiques)
REVER,12/06/2013,20000,6000,9000,15000,6000,9000,15000,14/02/2014,Mesure 2.01 : Stimulation du potentiel technologique des PME (Action 2.1.4 - Chèques Technologiques)
RA CONCEPT,13/06/2013,20000,6000,9000,15000,6000,9000,15000,18/12/2013,Mesure 2.01 : Stimulation du potentiel technologique des PME (Action 2.1.4 - Chèques Technologiques)
IPRATECH,03/07/2013,500,150,225,375,150,225,375,27/07/2015,Mesure 2.01 : Stimulation du potentiel technologique des PME (Action 2.1.4 - Chèques Technologiques)
GEOGRIND,25/06/2013,7000,2100,3150,5250,2100,3150,5250,20/02/2015,Mesure 2.01 : Stimulation du potentiel technologique des PME (Action 2.1.4 - Chèques Technologiques)
TF CO,13/08/2013,5000,1500,2250,3750,1500,2250,3750,14/02/2014,Mesure 2.01 : Stimulation du potentiel technologique des PME (Action 2.1.4 - Chèques Technologiques)
COMET TRAITEMENTS,12/08/2013,8000,2400,3600,6000,2400,3600,6000,6/11/2013,Mesure 2.01 : Stimulation du potentiel technologique des PME (Action 2.1.4 - Chèques Technologiques)
PROCOTEX CORPORATION,28/06/2013,1000,300,450,750,300,450,750,13/11/2015,Mesure 2.01 : Stimulation du potentiel technologique des PME (Action 2.1.4 - Chèques Technologiques)
GREEN2CHEM CONSULTING,01/07/2013,7000,2100,3150,5250,2100,3150,5250,23/12/2015,Mesure 2.01 : Stimulation du potentiel technologique des PME (Action 2.1.4 - Chèques Technologiques)
I-MOVIX,05/07/2013,9000,2700,4050,6750,2700,4050,6750,20/02/2015,Mesure 2.01 : Stimulation du potentiel technologique des PME (Action 2.1.4 - Chèques Technologiques)
NEOCERAM,11/07/2013,20000,6000,9000,15000,6000,9000,15000,27/05/2014,Mesure 2.01 : Stimulation du potentiel technologique des PME (Action 2.1.4 - Chèques Technologiques)
THERMIBEL,25/07/2013,2000,600,900,1500,600,900,1500,10/12/2013,Mesure 2.01 : Stimulation du potentiel technologique des PME (Action 2.1.4 - Chèques Technologiques)
LES ATELIERS DE BLICQUY,26/07/2013,1000,300,450,750,300,450,750,24/09/2013,Mesure 2.01 : Stimulation du potentiel technologique des PME (Action 2.1.4 - Chèques Technologiques)
COVER GROUP,01/08/2013,19500,5850,8775,14625,5850,8775,14625,27/02/2014,Mesure 2.01 : Stimulation du potentiel technologique des PME (Action 2.1.4 - Chèques Technologiques)
Etablissements Jarilux,02/08/2013,4000,1200,1800,3000,1200,1800,3000,27/02/2014,Mesure 2.01 : Stimulation du potentiel technologique des PME (Action 2.1.4 - Chèques Technologiques)
IPRATECH,19/08/2013,500,150,225,375,150,225,375,27/07/2015,Mesure 2.01 : Stimulation du potentiel technologique des PME (Action 2.1.4 - Chèques Technologiques)
COMET TRAITEMENTS,14/08/2013,4000,1200,1800,3000,1200,1800,3000,6/11/2013,Mesure 2.01 : Stimulation du potentiel technologique des PME (Action 2.1.4 - Chèques Technologiques)
H.O.P.,26/08/2013,4500,1350,2025,3375,1350,2025,3375,19/11/2013,Mesure 2.01 : Stimulation du potentiel technologique des PME (Action 2.1.4 - Chèques Technologiques)
CHEMBO,02/09/2013,7500,2250,3375,5625,2250,3375,5625,27/02/2014,Mesure 2.01 : Stimulation du potentiel technologique des PME (Action 2.1.4 - Chèques Technologiques)
FOOD PARTNERS CO,03/09/2013,1500,450,675,1125,450,675,1125,24/09/2013,Mesure 2.01 : Stimulation du potentiel technologique des PME (Action 2.1.4 - Chèques Technologiques)
A-M-B- CONSTRUCT,09/09/2013,20000,6000,9000,15000,6000,9000,15000,5/11/2014,Mesure 2.01 : Stimulation du potentiel technologique des PME (Action 2.1.4 - Chèques Technologiques)
SIFACO BENELUX,23/09/2013,10000,3000,4500,7500,3000,4500,7500,14/02/2014,Mesure 2.01 : Stimulation du potentiel technologique des PME (Action 2.1.4 - Chèques Technologiques)
METAL QUARTZ,13/09/2013,15000,4500,6750,11250,4500,6750,11250,18/12/2013,Mesure 2.01 : Stimulation du potentiel technologique des PME (Action 2.1.4 - Chèques Technologiques)
LEBAILLY,16/09/2013,12000,3600,5400,9000,3600,5400,9000,27/07/2015,Mesure 2.01 : Stimulation du potentiel technologique des PME (Action 2.1.4 - Chèques Technologiques)
BEADS BELGIUM,19/09/2013,17500,5250,7875,13125,5250,7875,13125,18/12/2013,Mesure 2.01 : Stimulation du potentiel technologique des PME (Action 2.1.4 - Chèques Technologiques)
Les Produits Purs de Courcelles,23/09/2013,5000,1500,2250,3750,1500,2250,3750,5/11/2014,Mesure 2.01 : Stimulation du potentiel technologique des PME (Action 2.1.4 - Chèques Technologiques)
OXYLENT,24/09/2013,1000,300,450,750,300,450,750,5/11/2013,Mesure 2.01 : Stimulation du potentiel technologique des PME (Action 2.1.4 - Chèques Technologiques)
SOCIETE COMINOISE DE MAILLE INDUSTRIELLE,20/11/2013,10000,3000,4500,7500,3000,4500,7500,5/11/2014,Mesure 2.01 : Stimulation du potentiel technologique des PME (Action 2.1.4 - Chèques Technologiques)
BIZZDEV,3/10/2013,9000,2700,4050,6750,2700,4050,6750,31/03/2014,Mesure 2.01 : Stimulation du potentiel technologique des PME (Action 2.1.4 - Chèques Technologiques)
LEBAILLY,18/10/2013,4500,1350,2025,3375,1350,2025,3375,27/08/2014,Mesure 2.01 : Stimulation du potentiel technologique des PME (Action 2.1.4 - Chèques Technologiques)
EURO ROAD PROFESSIONNAL CLEANING,10/10/2013,5000,1500,2250,3750,1500,2250,3750,11/07/2014,Mesure 2.01 : Stimulation du potentiel technologique des PME (Action 2.1.4 - Chèques Technologiques)
FOOD INGREDIENTS TECHNOLOGIES,6/11/2013,7500,2250,3375,5625,2250,3375,5625,13/11/2015,Mesure 2.01 : Stimulation du potentiel technologique des PME (Action 2.1.4 - Chèques Technologiques)
Grandes Distilleries de Charleroi,23/10/2013,1000,300,450,750,300,450,750,27/07/2015,Mesure 2.01 : Stimulation du potentiel technologique des PME (Action 2.1.4 - Chèques Technologiques)
RECOVAL BELGIUM,15/10/2013,1000,300,450,750,300,450,750,10/12/2013,Mesure 2.01 : Stimulation du potentiel technologique des PME (Action 2.1.4 - Chèques Technologiques)
LEBAILLY,18/10/2013,3500,1050,1575,2625,1050,1575,2625,30/03/2015,Mesure 2.01 : Stimulation du potentiel technologique des PME (Action 2.1.4 - Chèques Technologiques)
L'ECOPAIN D'IGNACE,25/10/2013,1000,300,450,750,300,450,750,10/12/2013,Mesure 2.01 : Stimulation du potentiel technologique des PME (Action 2.1.4 - Chèques Technologiques)
BIOHAINAUT,12/11/2013,2000,600,900,1500,600,900,1500,11/03/2014,Mesure 2.01 : Stimulation du potentiel technologique des PME (Action 2.1.4 - Chèques Technologiques)
ioteo,20/11/2013,20000,6000,9000,15000,6000,9000,15000,20/02/2015,Mesure 2.01 : Stimulation du potentiel technologique des PME (Action 2.1.4 - Chèques Technologiques)
BAKBEL EUROPE,10/12/2013,2000,600,900,1500,300,450,750,13/11/2015,Mesure 2.01 : Stimulation du potentiel technologique des PME (Action 2.1.4 - Chèques Technologiques)
SOCIETE NOUVELLE HAINAUT CARLIER,4/12/2013,1500,450,675,1125,450,675,1125,14/02/2014,Mesure 2.01 : Stimulation du potentiel technologique des PME (Action 2.1.4 - Chèques Technologiques)
OXYLENT,6/12/2013,2000,600,900,1500,600,900,1500,11/07/2014,Mesure 2.01 : Stimulation du potentiel technologique des PME (Action 2.1.4 - Chèques Technologiques)
BIOHAINAUT,3/12/2013,8500,2550,3825,6375,2550,3825,6375,27/02/2014,Mesure 2.01 : Stimulation du potentiel technologique des PME (Action 2.1.4 - Chèques Technologiques)
Uniteq,5/12/2013,6000,1800,2700,4500,1800,2700,4500,28/05/2014,Mesure 2.01 : Stimulation du potentiel technologique des PME (Action 2.1.4 - Chèques Technologiques)
H.O.P.,26/03/2014,4000,1200,1800,3000,1200,1800,3000,3/12/2014,Mesure 2.01 : Stimulation du potentiel technologique des PME (Action 2.1.4 - Chèques Technologiques)
F.L. CONSULTING,5/12/2013,20000,6000,9000,15000,6000,9000,15000,20/02/2015,Mesure 2.01 : Stimulation du potentiel technologique des PME (Action 2.1.4 - Chèques Technologiques)
TRYAL INV.,10/12/2013,5500,1650,2475,4125,1650,2475,4125,16/05/2014,Mesure 2.01 : Stimulation du potentiel technologique des PME (Action 2.1.4 - Chèques Technologiques)
DECOCK YOUNGPLANTS,13/12/2013,20000,6000,9000,15000,6000,9000,15000,28/10/2014,Mesure 2.01 : Stimulation du potentiel technologique des PME (Action 2.1.4 - Chèques Technologiques)
RECOVAL BELGIUM,18/12/2013,15000,4500,6750,11250,4500,6750,11250,27/07/2015,Mesure 2.01 : Stimulation du potentiel technologique des PME (Action 2.1.4 - Chèques Technologiques)
METAL QUARTZ,21/12/2013,3000,900,1350,2250,900,1350,2250,08/04/2014,Mesure 2.01 : Stimulation du potentiel technologique des PME (Action 2.1.4 - Chèques Technologiques)
PROCOTEX CORPORATION,20/12/2013,6000,1800,2700,4500,1800,2700,4500,3/12/2014,Mesure 2.01 : Stimulation du potentiel technologique des PME (Action 2.1.4 - Chèques Technologiques)
MENUISERIE E.M.A.C.,07/01/2014,6500,1950,2925,4875,1950,2925,4875,13/11/2015,Mesure 2.01 : Stimulation du potentiel technologique des PME (Action 2.1.4 - Chèques Technologiques)
I-MOVIX,31/12/2013,10000,3000,4500,7500,3000,4500,7500,20/02/2015,Mesure 2.01 : Stimulation du potentiel technologique des PME (Action 2.1.4 - Chèques Technologiques)
ENDO TOOLS THERAPEUTICS,26/12/2013,11000,3300,4950,8250,1650,2475,4125,13/11/2015,Mesure 2.01 : Stimulation du potentiel technologique des PME (Action 2.1.4 - Chèques Technologiques)
SERVICES PROSPECTIONS VENTES,30/12/2013,6000,1800,2700,4500,1800,2700,4500,13/11/2015,Mesure 2.01 : Stimulation du potentiel technologique des PME (Action 2.1.4 - Chèques Technologiques)
IMMOROUTE,27/01/2014,8000,2400,3600,6000,2400,3600,6000,28/05/2014,Mesure 2.01 : Stimulation du potentiel technologique des PME (Action 2.1.4 - Chèques Technologiques)
HERPI INTERNATIONAL,27/01/2014,3500,1050,1575,2625,900,1350,2250,30/03/2015,Mesure 2.01 : Stimulation du potentiel technologique des PME (Action 2.1.4 - Chèques Technologiques)
OXYLENT,05/02/2014,7000,2100,3150,5250,1800,2700,4500,11/03/2014,Mesure 2.01 : Stimulation du potentiel technologique des PME (Action 2.1.4 - Chèques Technologiques)
SUPERDYE,23/01/2014,1000,300,450,750,300,450,750,13/11/2015,Mesure 2.01 : Stimulation du potentiel technologique des PME (Action 2.1.4 - Chèques Technologiques)
BEADS BELGIUM,06/02/2014,12000,3600,5400,9000,3600,5400,9000,11/07/2014,Mesure 2.01 : Stimulation du potentiel technologique des PME (Action 2.1.4 - Chèques Technologiques)
Calcaires de la Sambre,10/02/2014,3500,1050,1575,2625,1050,1575,2625,27/08/2014,Mesure 2.01 : Stimulation du potentiel technologique des PME (Action 2.1.4 - Chèques Technologiques)
Etablissements Jarilux,17/02/2014,4000,1200,1800,3000,1200,1800,3000,26/09/2014,Mesure 2.01 : Stimulation du potentiel technologique des PME (Action 2.1.4 - Chèques Technologiques)
ITEOS THERAPEUTICS,19/02/2014,12000,3600,5400,9000,1050,1575,2625,20/02/2015,Mesure 2.01 : Stimulation du potentiel technologique des PME (Action 2.1.4 - Chèques Technologiques)
SIFACO BENELUX,07/03/2014,20000,6000,9000,15000,6000,9000,15000,27/07/2015,Mesure 2.01 : Stimulation du potentiel technologique des PME (Action 2.1.4 - Chèques Technologiques)
Etablissements VAN MELLO,22/03/2014,6000,1800,2700,4500,1800,2700,4500,13/11/2015,Mesure 2.01 : Stimulation du potentiel technologique des PME (Action 2.1.4 - Chèques Technologiques)
WASTE OIL SERVICES HAUTRAGE,20/03/2014,7000,2100,3150,5250,2100,3150,5250,16/05/2014,Mesure 2.01 : Stimulation du potentiel technologique des PME (Action 2.1.4 - Chèques Technologiques)
GREEN2CHEM CONSULTING,15/04/2014,8000,2400,3600,6000,2100,3150,5250,20/04/2015,Mesure 2.01 : Stimulation du potentiel technologique des PME (Action 2.1.4 - Chèques Technologiques)
MENUISERIE E.M.A.C.,31/03/2014,9000,2700,4050,6750,2700,4050,6750,30/03/2015,Mesure 2.01 : Stimulation du potentiel technologique des PME (Action 2.1.4 - Chèques Technologiques)
REVER,31/03/2014,8000,2400,3600,6000,2400,3600,6000,13/11/2015,Mesure 2.01 : Stimulation du potentiel technologique des PME (Action 2.1.4 - Chèques Technologiques)
METAL QUARTZ,04/04/2014,16000,4800,7200,12000,4800,7200,12000,11/07/2014,Mesure 2.01 : Stimulation du potentiel technologique des PME (Action 2.1.4 - Chèques Technologiques)
ALANINE,10/04/2014,4500,1350,2025,3375,1350,2025,3375,20/02/2015,Mesure 2.01 : Stimulation du potentiel technologique des PME (Action 2.1.4 - Chèques Technologiques)
NEG - Nouveaux Entrepôts et Garages,25/04/2014,19500,5850,8775,14625,5850,8775,14625,20/02/2015,Mesure 2.01 : Stimulation du potentiel technologique des PME (Action 2.1.4 - Chèques Technologiques)
TOTAL CONCEPT,17/04/2014,16500,4950,7425,12375,4500,6750,11250,27/07/2015,Mesure 2.01 : Stimulation du potentiel technologique des PME (Action 2.1.4 - Chèques Technologiques)
CHEMBO,09/04/2014,2000,600,900,1500,600,900,1500,5/11/2014,Mesure 2.01 : Stimulation du potentiel technologique des PME (Action 2.1.4 - Chèques Technologiques)
D VIN,16/04/2014,5000,1500,2250,3750,1500,2250,3750,13/11/2015,Mesure 2.01 : Stimulation du potentiel technologique des PME (Action 2.1.4 - Chèques Technologiques)
Les Produits Purs de Courcelles,2/10/2014,5000,1500,2250,3750,1500,2250,3750,20/02/2015,Mesure 2.01 : Stimulation du potentiel technologique des PME (Action 2.1.4 - Chèques Technologiques)
COOK'N FIT,22/04/2014,7500,2250,3375,5625,2250,3375,5625,13/11/2015,Mesure 2.01 : Stimulation du potentiel technologique des PME (Action 2.1.4 - Chèques Technologiques)
BOUCHONS LECLERCQ ET FILS,25/04/2014,6000,1800,2700,4500,1800,2700,4500,13/11/2015,Mesure 2.01 : Stimulation du potentiel technologique des PME (Action 2.1.4 - Chèques Technologiques)
ENERBAN,07/05/2014,20000,6000,9000,15000,6000,9000,15000,26/09/2014,Mesure 2.01 : Stimulation du potentiel technologique des PME (Action 2.1.4 - Chèques Technologiques)
OXYLENT,24/04/2014,500,150,225,375,150,225,375,11/07/2014,Mesure 2.01 : Stimulation du potentiel technologique des PME (Action 2.1.4 - Chèques Technologiques)
Brasserie Dubuisson fréres,28/04/2014,10000,3000,4500,7500,3000,4500,7500,26/05/2015,Mesure 2.01 : Stimulation du potentiel technologique des PME (Action 2.1.4 - Chèques Technologiques)
INTERSYSTO,29/04/2014,20000,6000,9000,15000,6000,9000,15000,20/02/2015,Mesure 2.01 : Stimulation du potentiel technologique des PME (Action 2.1.4 - Chèques Technologiques)
SPYTANK,05/05/2014,4500,1350,2025,3375,1350,2025,3375,03/07/2014,Mesure 2.01 : Stimulation du potentiel technologique des PME (Action 2.1.4 - Chèques Technologiques)
OXYLENT,12/05/2014,3000,900,1350,2250,900,1350,2250,20/02/2015,Mesure 2.01 : Stimulation du potentiel technologique des PME (Action 2.1.4 - Chèques Technologiques)
COMET TRAITEMENTS,12/05/2014,10500,3150,4725,7875,3150,4725,7875,30/03/2015,Mesure 2.01 : Stimulation du potentiel technologique des PME (Action 2.1.4 - Chèques Technologiques)
ADVANCED ORTHOPEDIC SYSTEM,12/05/2014,3500,1050,1575,2625,1050,1575,2625,13/11/2015,Mesure 2.01 : Stimulation du potentiel technologique des PME (Action 2.1.4 - Chèques Technologiques)
IMMOROUTE,19/05/2014,500,150,225,375,150,225,375,15/09/2014,Mesure 2.01 : Stimulation du potentiel technologique des PME (Action 2.1.4 - Chèques Technologiques)
POMPES NEPTUNE,24/09/2014,20000,6000,9000,15000,6000,9000,15000,13/11/2015,Mesure 2.01 : Stimulation du potentiel technologique des PME (Action 2.1.4 - Chèques Technologiques)
EMPHASE ENVIRONNEMENT,22/05/2014,18000,5400,8100,13500,5400,8100,13500,13/11/2015,Mesure 2.01 : Stimulation du potentiel technologique des PME (Action 2.1.4 - Chèques Technologiques)
AKKRO MEDIA,10/07/2014,20000,6000,9000,15000,6000,9000,15000,13/11/2015,Mesure 2.01 : Stimulation du potentiel technologique des PME (Action 2.1.4 - Chèques Technologiques)
WASTE OIL SERVICES HAUTRAGE,18/06/2014,5000,1500,2250,3750,1500,2250,3750,29/08/2014,Mesure 2.01 : Stimulation du potentiel technologique des PME (Action 2.1.4 - Chèques Technologiques)
BONE THERAPEUTICS,18/06/2014,20000,6000,9000,15000,3000,4500,7500,20/02/2015,Mesure 2.01 : Stimulation du potentiel technologique des PME (Action 2.1.4 - Chèques Technologiques)
OVIZIO IMAGING SYSTEMS,27/06/2014,9000,2700,4050,6750,2700,4050,6750,13/11/2015,Mesure 2.01 : Stimulation du potentiel technologique des PME (Action 2.1.4 - Chèques Technologiques)
it4ip,21/07/2014,13500,4050,6075,10125,4050,6075,10125,13/11/2015,Mesure 2.01 : Stimulation du potentiel technologique des PME (Action 2.1.4 - Chèques Technologiques)
IMMOROUTE,01/07/2014,3500,1050,1575,2625,1050,1575,2625,20/02/2015,Mesure 2.01 : Stimulation du potentiel technologique des PME (Action 2.1.4 - Chèques Technologiques)
FOOD IMPACT,11/07/2014,12500,3750,5625,9375,3750,5625,9375,20/02/2015,Mesure 2.01 : Stimulation du potentiel technologique des PME (Action 2.1.4 - Chèques Technologiques)
Industrial Consulting Automation Research Engineering,07/08/2014,10000,3000,4500,7500,3000,4500,7500,15/09/2014,Mesure 2.01 : Stimulation du potentiel technologique des PME (Action 2.1.4 - Chèques Technologiques)
CHEMBO,22/07/2014,2000,600,900,1500,600,900,1500,28/10/2014,Mesure 2.01 : Stimulation du potentiel technologique des PME (Action 2.1.4 - Chèques Technologiques)
NEOCERAM,29/07/2014,20000,6000,9000,15000,6000,9000,15000,27/07/2015,Mesure 2.01 : Stimulation du potentiel technologique des PME (Action 2.1.4 - Chèques Technologiques)
LE BANANIE,01/08/2014,1000,300,450,750,300,450,750,28/08/2014,Mesure 2.01 : Stimulation du potentiel technologique des PME (Action 2.1.4 - Chèques Technologiques)
Prefarails,11/08/2014,11500,3450,5175,8625,3450,5175,8625,5/11/2014,Mesure 2.01 : Stimulation du potentiel technologique des PME (Action 2.1.4 - Chèques Technologiques)
Asinerie du Pays des Collines,27/08/2014,1000,300,450,750,300,450,750,28/10/2014,Mesure 2.01 : Stimulation du potentiel technologique des PME (Action 2.1.4 - Chèques Technologiques)
PRODUCTION INDUSTRIELLE PHIL DESIGN STUDIO,02/03/2015,2500,750,1125,1875,750,1125,1875,13/11/2015,Mesure 2.01 : Stimulation du potentiel technologique des PME (Action 2.1.4 - Chèques Technologiques)
BIOHAINAUT,20/08/2014,2500,750,1125,1875,450,675,1125,5/11/2014,Mesure 2.01 : Stimulation du potentiel technologique des PME (Action 2.1.4 - Chèques Technologiques)
GEOGRIND,10/09/2014,8000,2400,3600,6000,2400,3600,6000,20/04/2015,Mesure 2.01 : Stimulation du potentiel technologique des PME (Action 2.1.4 - Chèques Technologiques)
DISTILLERIE DU CENTENAIRE,08/09/2014,2000,600,900,1500,600,900,1500,30/03/2015,Mesure 2.01 : Stimulation du potentiel technologique des PME (Action 2.1.4 - Chèques Technologiques)
LE CONDITIONNEMENT BELGE,17/09/2014,4500,1350,2025,3375,1350,2025,3375,3/12/2014,Mesure 2.01 : Stimulation du potentiel technologique des PME (Action 2.1.4 - Chèques Technologiques)
CHEMBO,08/09/2014,1000,300,450,750,300,450,750,5/11/2014,Mesure 2.01 : Stimulation du potentiel technologique des PME (Action 2.1.4 - Chèques Technologiques)
TAXUSHARVEST,18/09/2014,6500,1950,2925,4875,1950,2925,4875,27/07/2015,Mesure 2.01 : Stimulation du potentiel technologique des PME (Action 2.1.4 - Chèques Technologiques)
ECOFROST,16/09/2014,9000,2700,4050,6750,2400,3600,6000,20/02/2015,Mesure 2.01 : Stimulation du potentiel technologique des PME (Action 2.1.4 - Chèques Technologiques)
ECO PRINTS,3/10/2014,2000,600,900,1500,600,900,1500,27/07/2015,Mesure 2.01 : Stimulation du potentiel technologique des PME (Action 2.1.4 - Chèques Technologiques)
TAXUSHARVEST,19/09/2014,3000,900,1350,2250,900,1350,2250,20/02/2015,Mesure 2.01 : Stimulation du potentiel technologique des PME (Action 2.1.4 - Chèques Technologiques)
GREEN2CHEM CONSULTING,1/10/2014,12000,3600,5400,9000,3600,5400,9000,08/06/2015,Mesure 2.01 : Stimulation du potentiel technologique des PME (Action 2.1.4 - Chèques Technologiques)
Etablissements Jarilux,26/09/2014,4000,1200,1800,3000,1200,1800,3000,13/11/2015,Mesure 2.01 : Stimulation du potentiel technologique des PME (Action 2.1.4 - Chèques Technologiques)
STORME,3/10/2014,6000,1800,2700,4500,1800,2700,4500,13/11/2015,Mesure 2.01 : Stimulation du potentiel technologique des PME (Action 2.1.4 - Chèques Technologiques)
Tech4Rail,6/10/2014,19000,5700,8550,14250,5700,8550,14250,20/02/2015,Mesure 2.01 : Stimulation du potentiel technologique des PME (Action 2.1.4 - Chèques Technologiques)
SMARTWEAR,15/10/2014,17000,5100,7650,12750,5100,7650,12750,20/02/2015,Mesure 2.01 : Stimulation du potentiel technologique des PME (Action 2.1.4 - Chèques Technologiques)
ACIC,15/10/2014,20000,6000,9000,15000,6000,9000,15000,13/11/2015,Mesure 2.01 : Stimulation du potentiel technologique des PME (Action 2.1.4 - Chèques Technologiques)
AGROFUTUR,16/10/2014,20000,6000,9000,15000,6000,9000,15000,13/11/2015,Mesure 2.01 : Stimulation du potentiel technologique des PME (Action 2.1.4 - Chèques Technologiques)
AGROMYL,3/11/2014,8500,2550,3825,6375,2550,3825,6375,26/05/2015,Mesure 2.01 : Stimulation du potentiel technologique des PME (Action 2.1.4 - Chèques Technologiques)
PRODUCTION INDUSTRIELLE PHIL DESIGN STUDIO,02/03/2015,7500,2250,3375,5625,2250,3375,5625,13/11/2015,Mesure 2.01 : Stimulation du potentiel technologique des PME (Action 2.1.4 - Chèques Technologiques)
ENDO TOOLS THERAPEUTICS,13/11/2014,1500,450,675,1125,450,675,1125,13/11/2015,Mesure 2.01 : Stimulation du potentiel technologique des PME (Action 2.1.4 - Chèques Technologiques)
Les Produits Purs de Courcelles,10/11/2014,5000,1500,2250,3750,1500,2250,3750,26/05/2015,Mesure 2.01 : Stimulation du potentiel technologique des PME (Action 2.1.4 - Chèques Technologiques)
OVIZIO IMAGING SYSTEMS,14/11/2014,1000,300,450,750,300,450,750,13/11/2015,Mesure 2.01 : Stimulation du potentiel technologique des PME (Action 2.1.4 - Chèques Technologiques)
AGROMYL,14/11/2014,11000,3300,4950,8250,3300,4950,8250,26/05/2015,Mesure 2.01 : Stimulation du potentiel technologique des PME (Action 2.1.4 - Chèques Technologiques)
NIEZEN,26/11/2014,8000,2400,3600,6000,2400,3600,6000,13/11/2015,Mesure 2.01 : Stimulation du potentiel technologique des PME (Action 2.1.4 - Chèques Technologiques)
ADVANCED ORTHOPEDIC SYSTEM,6/12/2014,10000,3000,4500,7500,3000,4500,7500,27/07/2015,Mesure 2.01 : Stimulation du potentiel technologique des PME (Action 2.1.4 - Chèques Technologiques)
ITEOS THERAPEUTICS,25/11/2014,8000,2400,3600,6000,2400,3600,6000,08/06/2015,Mesure 2.01 : Stimulation du potentiel technologique des PME (Action 2.1.4 - Chèques Technologiques)
PRODUCTION INDUSTRIELLE PHIL DESIGN STUDIO,02/03/2015,1000,300,450,750,300,450,750,13/11/2015,Mesure 2.01 : Stimulation du potentiel technologique des PME (Action 2.1.4 - Chèques Technologiques)
A-M-B- CONSTRUCT,10/12/2014,20000,6000,9000,15000,6000,9000,15000,13/11/2015,Mesure 2.01 : Stimulation du potentiel technologique des PME (Action 2.1.4 - Chèques Technologiques)
COVER GROUP,9/12/2014,20000,6000,9000,15000,6000,9000,15000,13/11/2015,Mesure 2.01 : Stimulation du potentiel technologique des PME (Action 2.1.4 - Chèques Technologiques)
PROCOTEX CORPORATION,19/12/2014,12500,3750,5625,9375,3750,5625,9375,13/11/2015,Mesure 2.01 : Stimulation du potentiel technologique des PME (Action 2.1.4 - Chèques Technologiques)
ADVANCED ORTHOPEDIC SYSTEM,20/12/2014,3000,900,1350,2250,900,1350,2250,13/11/2015,Mesure 2.01 : Stimulation du potentiel technologique des PME (Action 2.1.4 - Chèques Technologiques)
BC.net,17/12/2014,13500,4050,6075,10125,4050,6075,10125,13/11/2015,Mesure 2.01 : Stimulation du potentiel technologique des PME (Action 2.1.4 - Chèques Technologiques)
DIAROTECH,26/01/2015,20000,6000,9000,15000,6000,9000,15000,13/11/2015,Mesure 2.01 : Stimulation du potentiel technologique des PME (Action 2.1.4 - Chèques Technologiques)
I-MOVIX,18/12/2014,13000,3900,5850,9750,3900,5850,9750,27/07/2015,Mesure 2.01 : Stimulation du potentiel technologique des PME (Action 2.1.4 - Chèques Technologiques)
F.L. CONSULTING,12/12/2014,20000,6000,9000,15000,6000,9000,15000,13/11/2015,Mesure 2.01 : Stimulation du potentiel technologique des PME (Action 2.1.4 - Chèques Technologiques)
SOCIETE NOUVELLE HAINAUT CARLIER,16/12/2014,1500,450,675,1125,450,675,1125,30/03/2015,Mesure 2.01 : Stimulation du potentiel technologique des PME (Action 2.1.4 - Chèques Technologiques)
PROCOTEX CORPORATION,17/12/2014,7500,2250,3375,5625,1800,2700,4500,30/03/2015,Mesure 2.01 : Stimulation du potentiel technologique des PME (Action 2.1.4 - Chèques Technologiques)
SOCIETE COMINOISE DE MAILLE INDUSTRIELLE,17/12/2014,10000,3000,4500,7500,3000,4500,7500,13/11/2015,Mesure 2.01 : Stimulation du potentiel technologique des PME (Action 2.1.4 - Chèques Technologiques)
I-MOVIX,18/12/2014,7000,2100,3150,5250,2100,3150,5250,13/11/2015,Mesure 2.01 : Stimulation du potentiel technologique des PME (Action 2.1.4 - Chèques Technologiques)
QILIUM,17/12/2014,20000,6000,9000,15000,6000,9000,15000,27/07/2015,Mesure 2.01 : Stimulation du potentiel technologique des PME (Action 2.1.4 - Chèques Technologiques)
HIPPEROS,17/12/2014,20000,6000,9000,15000,6000,9000,15000,13/11/2015,Mesure 2.01 : Stimulation du potentiel technologique des PME (Action 2.1.4 - Chèques Technologiques)
IT-OPTICS,17/12/2014,16000,4800,7200,12000,4800,7200,12000,13/11/2015,Mesure 2.01 : Stimulation du potentiel technologique des PME (Action 2.1.4 - Chèques Technologiques)
IRE ELiT,09/01/2015,5500,1650,2475,4125,1650,2475,4125,13/11/2015,Mesure 2.01 : Stimulation du potentiel technologique des PME (Action 2.1.4 - Chèques Technologiques)
OXYLENT,19/12/2014,10500,3150,4725,7875,3150,4725,7875,13/11/2015,Mesure 2.01 : Stimulation du potentiel technologique des PME (Action 2.1.4 - Chèques Technologiques)
RECYTERRE,19/12/2014,2000,600,900,1500,600,900,1500,30/03/2015,Mesure 2.01 : Stimulation du potentiel technologique des PME (Action 2.1.4 - Chèques Technologiques)
Uniteq,22/12/2014,20000,6000,9000,15000,6000,9000,15000,13/11/2015,Mesure 2.01 : Stimulation du potentiel technologique des PME (Action 2.1.4 - Chèques Technologiques)
GEOGRIND,24/12/2014,7000,2100,3150,5250,2100,3150,5250,13/11/2015,Mesure 2.01 : Stimulation du potentiel technologique des PME (Action 2.1.4 - Chèques Technologiques)
GEOGRIND,24/12/2014,5000,1500,2250,3750,1500,2250,3750,13/11/2015,Mesure 2.01 : Stimulation du potentiel technologique des PME (Action 2.1.4 - Chèques Technologiques)
CHEMBO,05/01/2015,5000,1500,2250,3750,1500,2250,3750,26/05/2015,Mesure 2.01 : Stimulation du potentiel technologique des PME (Action 2.1.4 - Chèques Technologiques)
OXYLENT,16/01/2015,1000,300,450,750,300,450,750,27/07/2015,Mesure 2.01 : Stimulation du potentiel technologique des PME (Action 2.1.4 - Chèques Technologiques)
VAPOPLAST,26/01/2015,20000,6000,9000,15000,6000,9000,15000,13/11/2015,Mesure 2.01 : Stimulation du potentiel technologique des PME (Action 2.1.4 - Chèques Technologiques)
OXYLENT,26/01/2015,1000,300,450,750,300,450,750,30/03/2015,Mesure 2.01 : Stimulation du potentiel technologique des PME (Action 2.1.4 - Chèques Technologiques)
OVIZIO IMAGING SYSTEMS,03/02/2015,3500,1050,1575,2625,1050,1575,2625,13/11/2015,Mesure 2.01 : Stimulation du potentiel technologique des PME (Action 2.1.4 - Chèques Technologiques)
Escavèche du Clos Normand,10/02/2015,4000,1200,1800,3000,1200,1800,3000,13/11/2015,Mesure 2.01 : Stimulation du potentiel technologique des PME (Action 2.1.4 - Chèques Technologiques)
BELGIAN FIBERS MANUFACTURING,23/02/2015,6500,1950,2925,4875,1950,2925,4875,13/11/2015,Mesure 2.01 : Stimulation du potentiel technologique des PME (Action 2.1.4 - Chèques Technologiques)
ADDITYS,20/02/2015,6500,1950,2925,4875,1950,2925,4875,27/07/2015,Mesure 2.01 : Stimulation du potentiel technologique des PME (Action 2.1.4 - Chèques Technologiques)
NANO4,23/02/2015,500,150,225,375,150,225,375,08/06/2015,Mesure 2.01 : Stimulation du potentiel technologique des PME (Action 2.1.4 - Chèques Technologiques)
PRODUCTION INDUSTRIELLE PHIL DESIGN STUDIO ,02/03/2015,500,150,225,375,150,225,375,13/11/2015,Mesure 2.01 : Stimulation du potentiel technologique des PME (Action 2.1.4 - Chèques Technologiques)
METAL QUARTZ,03/03/2015,16000,4800,7200,12000,4800,7200,12000,27/07/2015,Mesure 2.01 : Stimulation du potentiel technologique des PME (Action 2.1.4 - Chèques Technologiques)
VERSCHUERE TECHNOLOGY,02/04/2015,12000,3600,5400,9000,3600,5400,9000,13/11/2015,Mesure 2.01 : Stimulation du potentiel technologique des PME (Action 2.1.4 - Chèques Technologiques)
HAULOGY.NET,26/03/2015,20000,6000,9000,15000,6000,9000,15000,13/11/2015,Mesure 2.01 : Stimulation du potentiel technologique des PME (Action 2.1.4 - Chèques Technologiques)
Etablissements POLLET,31/03/2015,20000,6000,9000,15000,6000,9000,15000,13/11/2015,Mesure 2.01 : Stimulation du potentiel technologique des PME (Action 2.1.4 - Chèques Technologiques)
N.T.,03/04/2015,5500,1650,2475,4125,1650,2475,4125,13/11/2015,Mesure 2.01 : Stimulation du potentiel technologique des PME (Action 2.1.4 - Chèques Technologiques)
I-MOVIX,07/04/2015,13000,3900,5850,9750,1800,2700,4500,13/11/2015,Mesure 2.01 : Stimulation du potentiel technologique des PME (Action 2.1.4 - Chèques Technologiques)
SERENITY,27/04/2015,15000,4500,6750,11250,4500,6750,11250,13/11/2015,Mesure 2.01 : Stimulation du potentiel technologique des PME (Action 2.1.4 - Chèques Technologiques)
L'ARTISANE FOOD,07/04/2015,17000,5100,7650,12750,5100,7650,12750,13/11/2015,Mesure 2.01 : Stimulation du potentiel technologique des PME (Action 2.1.4 - Chèques Technologiques)
MEUNIER GROUP,09/04/2015,7500,2250,3375,5625,2250,3375,5625,08/06/2015,Mesure 2.01 : Stimulation du potentiel technologique des PME (Action 2.1.4 - Chèques Technologiques)
DEXSIL LABS,21/04/2015,1500,450,675,1125,450,675,1125,27/07/2015,Mesure 2.01 : Stimulation du potentiel technologique des PME (Action 2.1.4 - Chèques Technologiques)
INTERSYSTO,15/04/2015,20000,6000,9000,15000,6000,9000,15000,13/11/2015,Mesure 2.01 : Stimulation du potentiel technologique des PME (Action 2.1.4 - Chèques Technologiques)
ATELIERS GRAUX,13/04/2015,5500,1650,2475,4125,1650,2475,4125,13/11/2015,Mesure 2.01 : Stimulation du potentiel technologique des PME (Action 2.1.4 - Chèques Technologiques)
GEOGRIND,08/05/2015,3000,900,1350,2250,900,1350,2250,13/11/2015,Mesure 2.01 : Stimulation du potentiel technologique des PME (Action 2.1.4 - Chèques Technologiques)
ADDITYS,28/04/2015,2000,600,900,1500,600,900,1500,13/11/2015,Mesure 2.01 : Stimulation du potentiel technologique des PME (Action 2.1.4 - Chèques Technologiques)
Les Produits Purs de Courcelles,12/05/2015,6000,1800,2700,4500,1800,2700,4500,13/11/2015,Mesure 2.01 : Stimulation du potentiel technologique des PME (Action 2.1.4 - Chèques Technologiques)
PUR VER,06/05/2015,4500,1350,2025,3375,1350,2025,3375,13/11/2015,Mesure 2.01 : Stimulation du potentiel technologique des PME (Action 2.1.4 - Chèques Technologiques)
Rubbergreen Industrie,21/05/2015,16500,4950,7425,12375,4950,7425,12375,13/11/2015,Mesure 2.01 : Stimulation du potentiel technologique des PME (Action 2.1.4 - Chèques Technologiques)
DECOCK YOUNGPLANTS,21/05/2015,20000,6000,9000,15000,1500,2250,3750,13/11/2015,Mesure 2.01 : Stimulation du potentiel technologique des PME (Action 2.1.4 - Chèques Technologiques)
Limited Edition,26/05/2015,15000,4500,6750,11250,4500,6750,11250,13/11/2015,Mesure 2.01 : Stimulation du potentiel technologique des PME (Action 2.1.4 - Chèques Technologiques)
MENUISERIE E.M.A.C.,26/05/2015,13500,4050,6075,10125,4050,6075,10125,13/11/2015,Mesure 2.01 : Stimulation du potentiel technologique des PME (Action 2.1.4 - Chèques Technologiques)
GREEN2CHEM CONSULTING,26/05/2015,7000,2100,3150,5250,2100,3150,5250,13/11/2015,Mesure 2.01 : Stimulation du potentiel technologique des PME (Action 2.1.4 - Chèques Technologiques)
SOPRISM,08/06/2015,20000,6000,9000,15000,6000,9000,15000,13/11/2015,Mesure 2.01 : Stimulation du potentiel technologique des PME (Action 2.1.4 - Chèques Technologiques)
SMARTWEAR,09/06/2015,18000,5400,8100,13500,5400,8100,13500,13/11/2015,Mesure 2.01 : Stimulation du potentiel technologique des PME (Action 2.1.4 - Chèques Technologiques)